.p	FUM|SUC|Ubiquinols|Ubiquinones
1-ACYLGLYCEROL-3-P-ACYLTRANSFER-RXN.p	ACP|ACYL-ACP|ACYL-SN-GLYCEROL-3P|L-PHOSPHATIDATE
1.1.1.168-RXN.c	2-DEHYDROPANTOYL-LACTONE|NADP|NADPH|PANTOYL-LACTONE|PROTON
1.1.1.215-RXN.c	CPD-377|GLUCONATE|NADP|NADPH|PROTON
1.1.1.262-RXN.c	2-AMINO-3-OXO-4-PHOSPHONOOXYBUTYRATE|4-PHOSPHONOOXY-THREONINE|NAD|NADH|PROTON
1.1.1.264-RXN.c	5-DEHYDROGLUCONATE|L-IDONATE|NAD-P-OR-NOP|NADH-P-OR-NOP|PROTON
1.1.1.271-RXN.c	GDP-4-DEHYDRO-6-DEOXY-D-MANNOSE|NADP|NADPH|PROTON
1.1.1.274-RXN.c	25-DIDEHYDRO-D-GLUCONATE|CPD-377|NADP|NADPH|PROTON
1.1.1.283-RXN.c	LACTALD|METHYL-GLYOXAL|NADP|NADPH|PROTON
1.1.1.39-RXN.c	CARBON-DIOXIDE|MAL|NAD|NADH|PYRUVATE
1.1.1.83-RXN.c	CARBON-DIOXIDE|CPD-660|NAD|NADH|PYRUVATE
1.13.11.16-RXN.c	2-3-DIHYDROXYPHENYL-PROPIONATE|CPD-157|OXYGEN-MOLECULE|PROTON
1.2.99.7-RXN.p	Aldehydes|Carboxylates|FAD|FADH2|WATER
1.3.1.9-RXN.c	ACYL-ACP|NAD|NADH|PROTON|TRANS-D2-ENOYL-ACP
1.5.1.20-RXN.c	5-METHYL-THF|METHYLENE-THF|NAD|NADH|PROTON
1.5.1.34-RXN.c	5678-TETRAHYDROPTERIDINE|67-DIHYDROPTERIDINE|NAD-P-OR-NOP|NADH-P-OR-NOP|PROTON
1.7.2.3-RXN.c	Cytochromes-C-Oxidized|Cytochromes-C-Reduced|PROTON|TRIMENTHLAMINE-N-O|TRIMETHYLAMINE|WATER
1.8.1.4-RXN.c	Dihydro-Lipoyl-Proteins|Lipoyl-Protein-N6-lipoyllysine|NAD|NADH|PROTON
1.8.4.12-RXN.c	Ox-Thioredoxin|Protein-L-methionine|Protein-L-methionine-R-S-oxides|Red-Thioredoxin|WATER
1.8.4.13-RXN.c	CPD-8989|MET|Ox-Thioredoxin|Red-Thioredoxin|WATER
1.8.4.13-RXN.e	CPD-8989|MET|Ox-Thioredoxin|Red-Thioredoxin|WATER
1.8.4.14-RXN.c	CPD-8990|MET|Ox-Thioredoxin|Red-Thioredoxin|WATER
1.8.4.4-RXN.c	CYS|CYSTINE|GLUTATHIONE|OXIDIZED-GLUTATHIONE
1.8.4.8-RXN.c	3-5-ADP|Ox-Thioredoxin|PAPS|PROTON|Red-Thioredoxin|SO3
1.97.1.4-A-RXN.c	CH33ADO|MET|Oxidized-flavodoxins|PYRUVFORMLY-CPLX|PYRUVFORMLY-INACTIVE-CPLX|Reduced-flavodoxins|S-ADENOSYLMETHIONINE
1PFRUCTPHOSN-RXN.c	ADP|ATP|FRU1P|FRUCTOSE-16-DIPHOSPHATE|PROTON
1TRANSKETO-RXN.c	D-SEDOHEPTULOSE-7-P|GAP|RIBOSE-5P|XYLULOSE-5-PHOSPHATE
2-DEHYDROPANTOATE-REDUCT-RXN.c	2-DEHYDROPANTOATE|L-PANTOATE|NADP|NADPH|PROTON
2-ISOPROPYLMALATESYN-RXN.c	2-KETO-ISOVALERATE|3-CARBOXY-3-HYDROXY-ISOCAPROATE|ACETYL-COA|CO-A|PROTON|WATER
2-METHYLCITRATE-DEHYDRATASE-RXN.c	CPD-1136|CPD-622|WATER
2-METHYLCITRATE-SYNTHASE-RXN.c	CO-A|CPD-622|OXALACETIC_ACID|PROPIONYL-COA|PROTON|WATER
2-OCTAPRENYL-6-METHOXYPHENOL-HYDROX-RXN.c	2-OCTAPRENYL-6-METHOXYPHENOL|NADP|NADPH|OCTAPRENYL-METHOXY-BENZOQUINONE|OXYGEN-MOLECULE|PROTON|WATER
2-OCTAPRENYL-6-OHPHENOL-METHY-RXN.c	2-OCTAPRENYL-6-HYDROXYPHENOL|2-OCTAPRENYL-6-METHOXYPHENOL|ADENOSYL-HOMO-CYS|PROTON|S-ADENOSYLMETHIONINE
2-OCTAPRENYL-METHOXY-BENZOQ-METH-RXN.c	ADENOSYL-HOMO-CYS|OCTAPRENYL-METHOXY-BENZOQUINONE|OCTAPRENYL-METHYL-METHOXY-BENZQ|PROTON|S-ADENOSYLMETHIONINE
2-OCTAPRENYLPHENOL-HYDROX-RXN.c	2-OCTAPRENYL-6-HYDROXYPHENOL|2-OCTAPRENYLPHENOL|NADP|NADPH|OXYGEN-MOLECULE|PROTON|WATER
2-OXOPENT-4-ENOATE-HYDRATASE-RXN.c	4-HYDROXY-2-KETOVALERATE|OXOPENTENOATE|WATER
2.1.1.34-RXN.c	2-O-Methylguanosine18|ADENOSYL-HOMO-CYS|PROTON|S-ADENOSYLMETHIONINE|tRNA-guanosine18
2.1.1.63-RXN.c	DNA-6-O-Methyl-Guanines|DNA-Guanines|PROT-CYS|Protein-S-methyl-L-cysteine
2.1.1.63-RXN.e	DNA-6-O-Methyl-Guanines|DNA-Guanines|PROT-CYS|Protein-S-methyl-L-cysteine
2.1.1.72-RXN.c	ADENOSYL-HOMO-CYS|DNA-6-Methyl-Amino-Purines|DNA-Adenines|PROTON|S-ADENOSYLMETHIONINE
2.1.1.77-RXN.c	ADENOSYL-HOMO-CYS|PROTEIN-L-BETA-ISOASPARTATES|PROTEIN-L-BETA-ISOSPARTATE-METHYL-ESTERS|S-ADENOSYLMETHIONINE
2.1.1.79-RXN.p	ADENOSYL-HOMO-CYS|PROTON|Phospholipid-Cyclopropane-Fatty-Acids|Phospholipid-Olefinic-Fatty-Acids|S-ADENOSYLMETHIONINE
2.3.1.118-RXN.c	ACETYL-COA|CO-A|N-Acetoxy-Arylamines|N-Hydroxy-Arylamines
2.3.1.128-RXN.c	ACETYL-COA|CO-A|Ribosomal-Protein-L-Alanines|Ribosomal-Protein-N-Acetyl-L-Alanines
2.3.1.157-RXN.c	ACETYL-COA|CO-A|GLUCOSAMINE-1P|N-ACETYL-D-GLUCOSAMINE-1-P|PROTON
2.3.1.179-RXN.c	3-oxo-cis-vaccenoyl-ACPs|ACP|CARBON-DIOXIDE|MALONYL-ACP|PROTON|Palmitoleoyl-ACPs
2.3.1.180-RXN.c	ACETYL-COA|Acetoacetyl-ACPs|CARBON-DIOXIDE|CO-A|MALONYL-ACP|PROTON
2.3.1.41-RXN.c	ACP|ACYL-ACP|B-KETOACYL-ACP|CARBON-DIOXIDE|MALONYL-ACP|PROTON
2.3.1.49-RXN.c	CITRATE-LYASE|HOLO-CITRATE-LYASE|PANTETHEINE-P
2.4.1.56-RXN.e	Lipopolysaccharides|N-ACETYL-ETCETERA-LIPOPOLYSACCHARIDE|UDP|UDP-N-ACETYL-D-GLUCOSAMINE
2.4.1.58-RXN.c	CPD-8523|Lipopolysaccharides|UDP
2.5.1.19-RXN.c	3-ENOLPYRUVYL-SHIKIMATE-5P|PHOSPHO-ENOL-PYRUVATE|Pi|SHIKIMATE-5P
2.5.1.64-RXN.c	2-KETOGLUTARATE|CARBON-DIOXIDE|CPD-9924|ISOCHORISMATE|PROTON
2.6.1.57-RXN.c	2-KETOGLUTARATE|Aromatic-Amino-Acids|GLT
2.6.1.7-RXN.c	2-KETOGLUTARATE|CPD-476|GLT
2.7.1.121-RXN.c	DIHYDROXY-ACETONE-PHOSPHATE|DIHYDROXYACETONE|PHOSPHO-ENOL-PYRUVATE|PYRUVATE
2.7.1.148-RXN.c	2-PHOSPHO-4-CYTIDINE-5-DIPHOSPHO-2-C-MET|4-CYTIDINE-5-DIPHOSPHO-2-C|ADP|ATP|PROTON
2.7.1.69-RXN.ce	Sugar|Sugar-Phosphate
2.7.10.1-RXN.p	ADP|ATP|PROTON|Protein-Tyrosines|Protein-tyrosine-phosphates
2.7.3.9-RXN.c	PHOSPHO-ENOL-PYRUVATE|PYRUVATE
2.7.7.1-RXN.c	ATP|NAD|NICOTINAMIDE_NUCLEOTIDE|PPI|PROTON
2.7.7.13-RXN.c	GDP-MANNOSE|GTP|MANNOSE-1P|PPI|PROTON
2.7.7.60-RXN.c	2-C-METHYL-D-ERYTHRITOL-4-PHOSPHATE|4-CYTIDINE-5-DIPHOSPHO-2-C|CTP|PPI|PROTON
2.7.7.61-RXN.c	2-5-TRIPHOSPHORIBOSYL-3-DEPHOSPHO-|APO-CITRATE-LYASE|HOLO-CITRATE-LYASE|PPI
2.7.7.8-RXN.c	Nucleoside-Diphosphates|Pi|ssRNAs
2.7.8.25-RXN.c	2-5-TRIPHOSPHORIBOSYL-3-DEPHOSPHO-|ADENINE|ATP|DEPHOSPHO-COA|PROTON
2.7.9.3-RXN.c	AMP|ATP|Pi|SE-2|SEPO3|WATER
2.8.1.6-RXN.c	BIOTIN|CH33ADO|DETHIOBIOTIN|MET|PROTON|S-ADENOSYLMETHIONINE|Sulfurated-Sulfur-Acceptors|Unsulfurated-Sulfur-Acceptors
2.9.1.1-RXN.c	Charged-SEC-tRNAs|L-seryl-SEC-tRNAs|PROTON|Pi|SEPO3
2OXOGLUTARATEDEH-RXN.c	2-KETOGLUTARATE|CARBON-DIOXIDE|CO-A|NAD|NADH|SUC-COA
2OXOGLUTDECARB-RXN.c	2-KETOGLUTARATE|CARBON-DIOXIDE|Oxo-glutarate-dehydro-suc-DH-lipoyl|Oxo-glutarate-dehydrogenase-lipoyl|PROTON
2PGADEHYDRAT-RXN.c	2-PG|PHOSPHO-ENOL-PYRUVATE|WATER
2TRANSKETO-RXN.c	ERYTHROSE-4P|FRUCTOSE-6P|GAP|XYLULOSE-5-PHOSPHATE
3-CH3-2-OXOBUTANOATE-OH-CH3-XFER-RXN.c	2-DEHYDROPANTOATE|2-KETO-ISOVALERATE|METHYLENE-THF|THF|WATER
3-DEHYDROQUINATE-DEHYDRATASE-RXN.c	3-DEHYDRO-SHIKIMATE|DEHYDROQUINATE|WATER
3-DEHYDROQUINATE-SYNTHASE-RXN.c	3-DEOXY-D-ARABINO-HEPTULOSONATE-7-P|DEHYDROQUINATE|Pi
3-HYDROXYDECANOYL-ACP-DEHYDR-RXN.c	OH-ACYL-ACP|TRANS-D2-ENOYL-ACP|WATER
3-ISOPROPYLMALDEHYDROG-RXN.c	2-D-THREO-HYDROXY-3-CARBOXY-ISOCAPROATE|CPD-7100|NAD|NADH|PROTON
3-ISOPROPYLMALISOM-RXN.c	3-CARBOXY-3-HYDROXY-ISOCAPROATE|CPD-9451|WATER
3-NUCLEOTID-RXN.c	3-Prime-Ribonucleoside-Monophosphates|Pi|Ribonucleosides|WATER
3-NUCLEOTID-RXN.p	3-Prime-Ribonucleoside-Monophosphates|Pi|Ribonucleosides|WATER
3-OCTAPRENYL-4-OHBENZOATE-DECARBOX-RXN.c	2-OCTAPRENYLPHENOL|3-OCTAPRENYL-4-HYDROXYBENZOATE|CARBON-DIOXIDE|PROTON
3-OXOACYL-ACP-REDUCT-RXN.c	B-KETOACYL-ACP|NADP|NADPH|OH-ACYL-ACP|PROTON
3-OXOACYL-ACP-SYNTH-BASE-RXN.c	ACETYL-ACP|ACP|Acetoacetyl-ACPs|CARBON-DIOXIDE|MALONYL-ACP|PROTON
3-OXOACYL-ACP-SYNTH-RXN.c	ACP|B-KETOACYL-ACP|CARBON-DIOXIDE|MALONYL-ACP|PROTON|Saturated-Fatty-Acyl-ACPs
3.1.11.1-RXN.c	DNA-N|Deoxy-Ribonucleoside-Monophosphates|WATER
3.1.11.2-RXN.c	DNA-N|Nucleoside-Monophosphates
3.1.11.6-RXN.c	Ribonucleoside-Monophosphates|SS-Oligodeoxyribonucleotides|Single-Stranded-DNAs|WATER
3.1.13.1-RXN.c	Nucleoside-Monophosphates|RNASE-II-DEGRADATION-SUBSTRATE-MRNA|WATER
3.1.13.3-RXN.c	Nucleoside-Monophosphates|Oligonucleotides|WATER
3.1.13.5-RXN.c	Nucleoside-Monophosphates|tRNA-Holder|tRNA-precursors
3.1.2.21-RXN.c	ACP|DODECANOATE|Dodecanoyl-ACPs|PROTON|WATER
3.1.21.1-RXN.p	5-phosphodinucleotides|5-phosphooligonucleotides|Double-Stranded-DNAs|WATER
3.1.21.2-RXN.c	5-phosphooligonucleotides|Single-Stranded-DNAs|WATER
3.1.21.3-RXN.c	ADP|ATP|DNA-N|Double-Stranded-DNA-with-terminal-PO4s|Pi|WATER
3.1.21.7-RXN.c	3-Hydroxy-Terminated-DNAs|5-Phospho-terminated-DNAs|DNA-N|WATER
3.1.22.4-RXN.c	DNA-Combined-With-Exogenous-DNA|Resolution-of-Recombinational-Junction|WATER
3.1.26.11-RXN.c	SS-Oligoribonucleotides|WATER|mature-tRNA|tRNA-precursors
3.1.26.12-RXN.p	RNASE-E-DEGRADATION-SUBSTRATE-MRNA|ssRNAs
3.1.26.3-RXN.p	RNASE-III-MRNA-PROCESSING-SUBSTRATE|RNASE-III-PROCESSING-PRODUCT-MRNA|WATER|ssRNAs
3.1.26.4-RXN.c	DNA-Holder|Nucleoside-Monophosphates|RNA-DNA-hybrids|WATER
3.1.26.5-RXN.c	CPD0-2352|CPD0-2353|WATER|ssRNAs
3.1.27.6-RXN.c	WATER|mRNAs|ssRNAs
3.1.27.6-RXN.p	WATER|mRNAs|ssRNAs
3.1.3.16-RXN.c	Pi|WATER
3.1.3.68-RXN.c	2-DEOXY-D-GLUCOSE|2-DEOXY-D-GLUCOSE-6-PHOSPHATE|Pi|WATER
3.1.3.74-RXN.c	PYRIDOXAL|PYRIDOXAL_PHOSPHATE|Pi|WATER
3.1.4.14-RXN.c	ACP|PANTETHEINE-P|WATER|apo-ACP
3.2.1.17-RXN.c	C5|N-acetyl-D-glucosamine|Peptidoglycans|WATER
3.2.1.21-RXN.p	Beta-D-glucosides|GLC|Non-Glucosylated-Glucose-Acceptors|WATER
3.2.1.52-RXN.c	Alcohols|N-Acetyl-beta-D-Hexosaminides|N-acetyl-beta-D-hexosamines|WATER
3.2.1.89-RXN.c	WATER|a-galctotetrose
3.2.2.21-RXN.c	Alkylated-Bases|Alkylated-DNAs|DNA-N|WATER
3.2.2.23-RXN.c	AP-Site-Created|WATER
3.4.11.1-RXN.c	Amino-Acids-20|WATER
3.4.11.18-RXN.c	MET|Protein-With-N-Terminal-Met|WATER
3.4.11.2-RXN.p	POLYPEPTIDE|WATER
3.4.11.4-RXN.c	Amino-Acids-20|DIPEPTIDES|TRIPEPTIDES|WATER
3.4.11.9-RXN.c	Amino-Acids-20|WATER
3.4.13.18-RXN.c	Amino-Acids-20|DIPEPTIDES|WATER
3.4.13.21-RXN.c	Amino-Acids-20|Dipeptides-With-Asp-At-N-Terminal|L-ASPARTATE|WATER
3.4.13.22-RXN.e	D-ALA-D-ALA|D-ALANINE|WATER
3.4.13.22-RXN.p	D-ALA-D-ALA|D-ALANINE|WATER
3.4.13.9-RXN.c	Amino-Acids-20|Dipeptides-With-Proline-Carboxy|PRO|WATER
3.4.15.5-RXN.c	DIPEPTIDES|OLIGOPEPTIDES|WATER
3.4.15.5-RXN.p	DIPEPTIDES|OLIGOPEPTIDES|WATER
3.4.16.4-RXN.p	D-ALANINE|NAcMur-4Peptide-NAcGlc-Undecaprenols|NAcMur-Peptide-NAcGlc-Undecaprenols|WATER
3.4.19.12-RXN.c	Thiols|Ubiquitin-C-terminal-thioesters|Ubiquitins|WATER
3.4.21.102-RXN.p	General-Protein-Substrates|WATER
3.4.21.53-RXN.c	General-Protein-Substrates|WATER
3.4.21.83-RXN.c	OLIGOPEPTIDES|WATER
3.4.21.87-RXN.p	General-Protein-Substrates|WATER
3.4.21.89-RXN.p	Leader-Sequences|Peptides-with-Leader-Sequence|WATER
3.4.21.92-RXN.c	General-Protein-Substrates|WATER
3.4.23.36-RXN.p	Lipoproteins|Prolipoproteins|WATER|cleaved-lipoprotein-signal-peptide
3.4.23.43-RXN.p	Cleaved-Type-IV-Prepillins|WATER|type-IV-prepillin
3.4.24.55-RXN.c	General-Protein-Substrates|WATER
3.4.24.55-RXN.p	General-Protein-Substrates|WATER
3.4.24.70-RXN.c	OLIGOPEPTIDES|WATER
3.5.1.28-RXN.c	NACMUR|Peptidoglycans|WATER
3.5.1.28-RXN.p	NACMUR|Peptidoglycans|WATER
3.5.1.88-RXN.c	FORMATE|FORMYL-L-METHIONYL-PEPTIDE|METHIONYL-PEPTIDE|WATER
3.6.1.19-RXN.c	Nucleoside-Monophosphates|Nucleoside-Triphosphates|PPI|PROTON|WATER
3.6.1.41-RXN.c	ADENOSYL-P4|ADP|PROTON|WATER
3.6.3.39-RXN.cp	ADP|ATP|Lipopolysaccharides|PROTON|Pi|WATER
325-BISPHOSPHATE-NUCLEOTIDASE-RXN.c	3-5-ADP|AMP|Pi|WATER
325-BISPHOSPHATE-NUCLEOTIDASE-RXN.p	3-5-ADP|AMP|Pi|WATER
3PGAREARR-RXN.c	2-PG|G3P
4-HYDROXYBUTYRATE-DEHYDROGENASE-RXN.c	4-HYDROXY-BUTYRATE|NAD|NADH|PROTON|SUCC-S-ALD
4-NITROPHENYLPHOSPHATASE-RXN.p	CPD-194|P-NITROPHENOL|PROTON|Pi|WATER
4.1.2.28-RXN.c	GLYCOLALDEHYDE|PYRUVATE
4.2.1.58-RXN.c	Beta-3-hydroxybutyryl-ACPs|Crotonyl-ACPs|WATER
4.2.1.59-RXN.c	2-Octenoyl-ACPs|3-Hydroxy-octanoyl-ACPs|WATER
4.2.1.61-RXN.c	2-Hexadecenoyl-ACPs|R-3-Hydroxypalmitoyl-ACPs|WATER
4.2.1.99-RXN.c	CPD-1136|CPD-618|WATER
4.2.99.18-RXN.c	3-terminal-unsaturated-sugars|5-Phosphopolynucleotides|DNA-containing-abasic-Sites
4.3.1.15-RXN.c	23-Diaminopropanoate|AMMONIUM|PROTON|PYRUVATE|WATER
4.3.1.17-RXN.c	AMMONIUM|PYRUVATE|SER
4OHBENZOATE-OCTAPRENYLTRANSFER-RXN.p	3-OCTAPRENYL-4-HYDROXYBENZOATE|4-hydroxybenzoate|OCTAPRENYL-DIPHOSPHATE|PPI
5-FORMYL-THF-CYCLO-LIGASE-RXN.c	5-10-METHENYL-THF|5-FORMYL-THF|ADP|ATP|Pi
5-NUCLEOTID-RXN.c	Pi|Ribonucleoside-Monophosphates|Ribonucleosides|WATER
5-NUCLEOTID-RXN.p	Pi|Ribonucleoside-Monophosphates|Ribonucleosides|WATER
5.1.3.20-RXN.c	ADP-D-GLYCERO-D-MANNO-HEPTOSE|ADP-L-GLYCERO-D-MANNO-HEPTOSE
5.3.3.14-RXN.c	Cis-delta-3-decenoyl-ACPs|Trans-D2-decenoyl-ACPs
5.3.4.1-RXN.c	Proteins-with-correct-disulfides|Proteins-with-incorrect-disulfides
5.3.4.1-RXN.p	Proteins-with-correct-disulfides|Proteins-with-incorrect-disulfides
5.4.2.10-RXN.c	D-GLUCOSAMINE-6-P|GLUCOSAMINE-1P
5.99.1.2-RXN.c	Negatively-super-coiled-DNAs|Relaxed-DNAs
5.99.1.3-RXN.c	ADP|ATP|Double-Stranded-DNAs|Negatively-super-coiled-DNAs|Pi
6-PHOSPHO-BETA-GLUCOSIDASE-RXN.c	CPD-507|GLC|GLC-6-P|WATER
6PFRUCTPHOS-RXN.c	ADP|ATP|FRUCTOSE-16-DIPHOSPHATE|FRUCTOSE-6P|PROTON
6PGLUCONDEHYDROG-RXN.c	CARBON-DIOXIDE|CPD-2961|NAD-P-OR-NOP|NADH-P-OR-NOP|RIBULOSE-5P
6PGLUCONOLACT-RXN.c	CPD-2961|D-6-P-GLUCONO-DELTA-LACTONE|PROTON|WATER
7-ALPHA-HYDROXYSTEROID-DEH-RXN.c	CHOLANATE2|CHOLATE|NAD|NADH|PROTON
7KAPSYN-RXN.c	8-AMINO-7-OXONONANOATE|CARBON-DIOXIDE|CO-A|CPD-558|L-ALPHA-ALANINE|PROTON
ABC-10-RXN.cp	ADP|ATP|FERRIC-ENTEROBACTIN-COMPLEX|PROTON|Pi|WATER
ABC-11-RXN.cp	ADP|ATP|Ferric-Hydroxamate-Complexes|Pi|WATER
ABC-12-RXN.cp	ADP|ATP|GLN|PROTON|Pi|WATER
ABC-13-RXN.cp	ADP|ATP|GLT|PROTON|Pi|WATER
ABC-14-RXN.cp	ADP|ATP|HIS|PROTON|Pi|WATER
ABC-15-RXN.cp	ADP|ATP|ILE|PROTON|Pi|WATER
ABC-16-RXN.cp	ADP|ATP|MALTOSE|PROTON|Pi|WATER
ABC-18-RXN.cp	ADP|ATP|GALACTOSE|PROTON|Pi|WATER
ABC-19-RXN.cp	ADP|ATP|CPD-3|PROTON|Pi|WATER
ABC-2-RXN.cp	ADP|ATP|L-ARABINOSE|PROTON|Pi|WATER
ABC-20-RXN.cp	ADP|ATP|NI+2|PROTON|Pi|WATER
ABC-22-RXN.cp	ADP|ATP|Peptides|Pi|WATER
ABC-23-RXN.cp	ADP|ATP|Alkylphosphonates|PROTON|Pi|WATER
ABC-24-RXN.cp	ADP|ATP|PROTON|Pi|SPERMIDINE|WATER
ABC-25-RXN.cp	ADP|ATP|PROTON|PUTRESCINE|Pi|WATER
ABC-26-RXN.cp	ADP|ATP|PRO|PROTON|Pi|WATER
ABC-27-RXN.cp	ADP|ATP|PROTON|Pi|WATER
ABC-28-RXN.cp	ADP|ATP|CPD0-1110|PROTON|Pi|WATER
ABC-3-RXN.cp	ADP|ATP|LYS|PROTON|Pi|WATER
ABC-32-RXN.cp	ADP|ATP|PROTON|Pi|THIAMINE|WATER
ABC-33-RXN.cp	ADP|ATP|D-Xylose|PROTON|Pi|WATER
ABC-34-RXN.cp	ADP|ATP|GLYCEROL-3P|PROTON|Pi|WATER
ABC-35-RXN.cp	ADP|ATP|LEU|PROTON|Pi|WATER
ABC-36-RXN.cp	ADP|ATP|PROTON|Pi|VAL|WATER
ABC-37-RXN.cp	ADP|ATP|L-ORNITHINE|PROTON|Pi|WATER
ABC-4-RXN.cp	ADP|ARG|ATP|PROTON|Pi|WATER
ABC-42-RXN.cp	ADP|ALLOSE|ATP|PROTON|Pi|WATER
ABC-5-RXN.cp	ADP|ATP|COB-I-ALAMIN|PROTON|Pi|WATER
ABC-56-RXN.cp	ADP|ATP|Aliphatic-Sulfonates|PROTON|Pi|WATER
ABC-63-RXN.cp	ADP|ATP|PROTON|Pi|WATER|ZN+2
ABC-64-RXN.cp	ADP|ATP|PROTON|Pi|TAURINE|WATER
ABC-7-RXN.cp	ADP|ATP|PROTON|Pi|S2O3|WATER
ABC-70-RXN.cp	ADP|ATP|PROTON|Pi|SULFATE|WATER
ABC-8-RXN.cp	ADP|ATP|DIPEPTIDES|PROTON|Pi|WATER
ABC-9-RXN.cp	ADP|ATP|FERRIC-CITRATE-COMPLEX|PROTON|Pi|WATER
ACECOATRANS-RXN.c	ACET|ACETYL-COA|Fatty-Acids|Saturated-Fatty-Acyl-CoA
ACETALD-DEHYDROG-RXN.c	ACETALD|ACETYL-COA|CO-A|NAD|NADH|PROTON
ACETATE--COA-LIGASE-RXN.c	ACET|ACETYL-COA|AMP|ATP|CO-A|PPI
ACETATEKIN-RXN.c	ACET|ACETYL-P|ADP|ATP
ACETATEKIN-RXN.e	ACET|ACETYL-P|ADP|ATP
ACETOACETYL-COA-TRANSFER-RXN.c	3-KETOBUTYRATE|ACET|ACETOACETYL-COA|ACETYL-COA
ACETOINDEHYDROG-A-RXN.c	ACETOIN|DIACETYL|NADP|NADPH|PROTON
ACETOLACTREDUCTOISOM-RXN.c	2-ACETO-LACTATE|NADP|NADPH|PROTON
ACETOLACTSYN-RXN.c	2-ACETO-LACTATE|CARBON-DIOXIDE|PROTON|PYRUVATE
ACETOOHBUTREDUCTOISOM-RXN.c	1-KETO-2-METHYLVALERATE|2-ACETO-2-HYDROXY-BUTYRATE|NADP|NADPH|PROTON
ACETOOHBUTSYN-RXN.c	2-ACETO-2-HYDROXY-BUTYRATE|2-OXOBUTANOATE|CARBON-DIOXIDE|PROTON|PYRUVATE
ACETYL-COA-ACETYLTRANSFER-RXN.c	ACETOACETYL-COA|ACETYL-COA|CO-A
ACETYL-COA-CARBOXYLTRANSFER-RXN.c	ACETYL-COA|ADP|ATP|HCO3|MALONYL-COA|PROTON|Pi
ACETYLESTERASE-RXN.c	ACET|Acetic-Esters|Alcohols|PROTON|WATER
ACETYLGLUTKIN-RXN.c	ACETYL-GLU|ADP|ATP|N-ACETYL-GLUTAMYL-P
ACETYLORNDEACET-RXN.c	ACET|L-ORNITHINE|N-ALPHA-ACETYLORNITHINE|WATER
ACETYLORNTRANSAM-RXN.c	2-KETOGLUTARATE|CPD-469|GLT|N-ALPHA-ACETYLORNITHINE
ACID-PHOSPHATASE-RXN.p	Alcohols|Orthophosphoric-Monoesters|Pi|WATER
ACNEULY-RXN.c	N-ACETYLNEURAMINATE|PYRUVATE
ACONITATE-DELTA-ISOMERASE-RXN.c	CIS-ACONITATE|CPD-225
ACONITATEDEHYDR-RXN.c	CIS-ACONITATE|CIT|WATER
ACONITATEHYDR-RXN.c	CIS-ACONITATE|THREO-DS-ISO-CITRATE|WATER
ACP-S-ACETYLTRANSFER-RXN.c	ACETYL-ACP|ACETYL-COA|ACP|CO-A
ACSERLY-RXN.c	ACET|ACETYLSERINE|CYS|HS|PROTON
ACYL-COA-HYDROLASE-RXN.c	ACYL-COA|CO-A|Carboxylates|PROTON|WATER
ACYLCOADEHYDROG-RXN.c	ETF-Oxidized|ETF-Reduced|PROTON|Saturated-Fatty-Acyl-CoA|TRANS-D2-ENOYL-COA
ACYLCOASYN-RXN.c	AMP|ATP|CO-A|CPD66-39|PPI|Saturated-Fatty-Acyl-CoA
ACYLGPEACYLTRANS-RXN.p	2-ACYL-GPE|ACP|ACYL-ACP|L-1-PHOSPHATIDYL-ETHANOLAMINE
ACYLPHOSPHATASE-RXN.c	Acyl-Phosphates|Carboxylates|PROTON|Pi|WATER
ADCLY-RXN.c	4-AMINO-4-DEOXYCHORISMATE|P-AMINO-BENZOATE|PROTON|PYRUVATE
ADDALT-RXN.c	AMMONIUM|DEOXYADENOSINE|DEOXYINOSINE|PROTON|WATER
ADENINE-DEAMINASE-RXN.c	ADENINE|AMMONIUM|HYPOXANTHINE|PROTON|WATER
ADENODEAMIN-RXN.c	ADENOSINE|AMMONIUM|INOSINE|PROTON|WATER
ADENOSINE-NUCLEOSIDASE-RXN.c	ADENINE|ADENOSINE|WATER
ADENOSINETRIPHOSPHATASE-RXN.c	ADP|ATP|PROTON|Pi|WATER
ADENOSYLHOMOCYSTEINE-NUCLEOSIDASE-RXN.c	ADENINE|ADENOSYL-HOMO-CYS|CPD-564|WATER
ADENPHOSPHOR-RXN.c	ADENINE|ADENOSINE|Pi|RIBOSE-1P
ADENPRIBOSYLTRAN-RXN.c	ADENINE|AMP|PPI|PRPP
ADENYL-KIN-RXN.c	ADP|AMP|ATP
ADENYLATECYC-RXN.c	ATP|CAMP|PPI
ADENYLOSUCCINATE-SYNTHASE-RXN.c	ADENYLOSUCC|GDP|GTP|IMP|L-ASPARTATE|PROTON|Pi
ADENYLYLSULFKIN-RXN.c	ADP|APS|ATP|PAPS|PROTON
ADOMET-DMK-METHYLTRANSFER-RXN.c	ADENOSYL-HOMO-CYS|CPD-12115|PROTON|REDUCED-MENAQUINONE|S-ADENOSYLMETHIONINE
ADPREDUCT-RXN.c	ADP|DADP|Ox-Thioredoxin|Red-Thioredoxin|WATER
ADPSUGPPHOSPHAT-RXN.c	ADP-SUGARS|AMP|Alpha-D-aldose-1-phosphates|WATER
AGMATIN-RXN.c	AGMATHINE|PUTRESCINE|UREA|WATER
AICARSYN-RXN.c	AICAR|FUM|P-RIBOSYL-4-SUCCCARB-AMINOIMIDAZOLE
AICARTRANSFORM-RXN.c	10-FORMYL-THF|AICAR|PHOSPHORIBOSYL-FORMAMIDO-CARBOXAMIDE|THF
AIRS-RXN.c	5-PHOSPHORIBOSYL-5-AMINOIMIDAZOLE|5-PHOSPHORIBOSYL-N-FORMYLGLYCINEAMIDINE|ADP|ATP|PROTON|Pi
AKBLIG-RXN.c	ACETYL-COA|AMINO-OXOBUT|CO-A|GLY|PROTON
ALADEHYDCHLORO-RXN.c	3-CHLORO-D-ALANINE|CL-|PROTON|S-CARBOXYMETHYL-D-CYSTEINE|THIOGLYCOLATE
ALANINE--TRNA-LIGASE-RXN.c	ALA-tRNAs|AMP|ATP|Charged-ALA-tRNAs|L-ALPHA-ALANINE|PPI|PROTON
ALANINE-AMINOTRANSFERASE-RXN.c	2-KETOGLUTARATE|GLT|L-ALPHA-ALANINE|PYRUVATE
ALARACECAT-RXN.c	D-ALANINE|L-ALPHA-ALANINE
ALCOHOL-DEHYDROG-GENERIC-RXN.c	Aldehydes|NAD|NADH|PROTON|Primary-Alcohols
ALCOHOL-DEHYDROG-RXN.c	ACETALD|ETOH|NAD|NADH|PROTON
ALCOHOL-DEHYDROGENASE-NADPORNOP+-RXN.c	Alcohols|Aldehydes|NADP|NADPH|PROTON
ALDEHYDE-DEHYDROGENASE-NADP+-RXN.c	Aldehydes|Carboxylates|NADP|NADPH|PROTON|WATER
ALDOSE-1-EPIMERASE-RXN.c	ALPHA-GLUCOSE|GLC
ALDOSE1EPIM-RXN.c	ALPHA-D-GALACTOSE|GALACTOSE
ALKAPHOSPHA-RXN.p	Alcohols|Orthophosphoric-Monoesters|Pi|WATER
ALLANTOATE-DEIMINASE-RXN.c	ALLANTOATE|AMMONIUM|CARBON-DIOXIDE|CPD0-2298|PROTON|WATER
ALLANTOINASE-RXN.c	ALLANTOATE|PROTON|S-ALLANTOIN|WATER
ALLOSE-KINASE-RXN.c	ADP|ATP|D-ALLOSE-6-PHOSPHATE|PROTON
ALPHA-AMYL-RXN.c	1-4-alpha-D-Glucan|WATER
ALPHAGALACTOSID-RXN.c	ALPHA-D-GALACTOSE|GLC|MELIBIOSE|WATER
ALTARCA-RXN.c	ARCA-MONOMER|ARCB-MONOMER|PHOSPHO-ARCA|PHOSPHO-ARCB717
ALTRO-OXIDOREDUCT-RXN.c	D-ALTRONATE|D-TAGATURONATE|NAD|NADH|PROTON
ALTRODEHYDRAT-RXN.c	2-DEHYDRO-3-DEOXY-D-GLUCONATE|D-ALTRONATE|WATER
AMACETOXID-RXN.p	AMINO-ACETONE|AMMONIUM|HYDROGEN-PEROXIDE|METHYL-GLYOXAL|OXYGEN-MOLECULE|WATER
AMINEOXID-RXN.p	AMMONIUM|Aldehydes|Aliphatic-Amines|HYDROGEN-PEROXIDE|OXYGEN-MOLECULE|WATER
AMINEPHEN-RXN.p	AMMONIUM|HYDROGEN-PEROXIDE|OXYGEN-MOLECULE|PHENYLACETALDEHYDE|PHENYLETHYLAMINE|WATER
AMINOBUTDEHYDROG-RXN.c	4-AMINO-BUTYRALDEHYDE|4-AMINO-BUTYRATE|NAD|NADH|PROTON|WATER
AMINOCYL-TRNA-HYDROLASE-RXN.c	N-Substituted-Amino-Acids|N-Substituted-Aminoacyl-tRNA|WATER|tRNA-Holder
AMINOPROPDEHYDROG-RXN.c	1-AMINO-PROPAN-2-OL|AMINO-ACETONE|NAD|NADH|PROTON
AMP-DEPHOSPHORYLATION-RXN.c	ADENOSINE|AMP|Pi|WATER
AMP-NUCLEOSID-RXN.c	ADENINE|AMP|RIBOSE-5P|WATER
AMPSYN-RXN.c	ADENYLOSUCC|AMP|FUM
AMYLOMALT-RXN.c	MALTOSE|MALTOTETRAOSE|MALTOTRIOSE
ANTHRANSYN-RXN.c	ANTHRANILATE|CHORISMATE|GLN|GLT|PROTON|PYRUVATE
ARABISOM-RXN.c	L-RIBULOSE
ARCA-RXN.c	ARCA-MONOMER|ARCB-MONOMER|PHOSPHO-ARCA|PHOSPHO-ARCB-HIS
ARCB-RXN.c	ADP|ARCB-MONOMER|ATP|PHOSPHO-ARCB-HIS
ARCB717-RXN.c	PHOSPHO-ARCB-ASP|PHOSPHO-ARCB717
ARCBTRANS-RXN.c	PHOSPHO-ARCB-ASP|PHOSPHO-ARCB-HIS
ARGDECARBOX-RXN.c	AGMATHINE|ARG|CARBON-DIOXIDE|PROTON
ARGDECARBOX-RXN.p	AGMATHINE|ARG|CARBON-DIOXIDE|PROTON
ARGININE--TRNA-LIGASE-RXN.c	AMP|ARG|ARG-tRNAs|ATP|Charged-ARG-tRNAs|PPI|PROTON
ARGININE-N-SUCCINYLTRANSFERASE-RXN.c	ARG|CO-A|CPD-421|PROTON|SUC-COA
ARGSUCCINLYA-RXN.c	ARG|FUM|L-ARGININO-SUCCINATE
ARGSUCCINSYN-RXN.c	AMP|ATP|L-ARGININO-SUCCINATE|L-ASPARTATE|L-CITRULLINE|PPI|PROTON
ARYLAMINE-N-ACETYLTRANSFERASE-RXN.c	ACETYL-COA|CO-A
ARYLSULFAT-RXN.p	Aryl-Alcohol|Aryl-Sulfate|PROTON|SULFATE|WATER
ASNSYNA-RXN.c	AMMONIUM|AMP|ASN|ATP|L-ASPARTATE|PPI|PROTON
ASNSYNB-RXN.c	AMP|ASN|ATP|GLN|GLT|L-ASPARTATE|PPI|PROTON|WATER
ASPAMINOTRANS-RXN.c	2-KETOGLUTARATE|GLT|L-ASPARTATE|OXALACETIC_ACID
ASPARAGHYD-RXN.c	AMMONIUM|ASN|L-ASPARTATE|WATER
ASPARAGHYD-RXN.p	AMMONIUM|ASN|L-ASPARTATE|WATER
ASPARAGINE--TRNA-LIGASE-RXN.c	AMP|ASN|ASN-tRNAs|ATP|Charged-ASN-tRNAs|PPI|PROTON
ASPARTASE-RXN.c	AMMONIUM|FUM|L-ASPARTATE
ASPARTATE--TRNA-LIGASE-RXN.c	AMP|ASP-tRNAs|ATP|Charged-ASP-tRNAs|L-ASPARTATE|PPI|PROTON
ASPARTATE-SEMIALDEHYDE-DEHYDROGENASE-RXN.c	L-ASPARTATE-SEMIALDEHYDE|L-BETA-ASPARTYL-P|NADP|NADPH|PROTON|Pi
ASPARTATEKIN-RXN.c	ADP|ATP|L-ASPARTATE|L-BETA-ASPARTYL-P
ASPCARBTRANS-RXN.c	CARBAMOYL-P|CARBAMYUL-L-ASPARTATE|L-ASPARTATE|PROTON|Pi
ASPDECARBOX-RXN.c	B-ALANINE|CARBON-DIOXIDE|L-ASPARTATE|PROTON
ATOC-RXN.c	ATOC-MONOMER|ATOS-MONOMER|PHOSPHO-ATOC|PHOSPHO-ATOS
ATPPHOSPHORIBOSYLTRANS-RXN.c	ATP|PHOSPHORIBOSYL-ATP|PPI|PROTON|PRPP
BADH-RXN.p	BETAINE|BETAINE_ALDEHYDE|NAD|NADH|PROTON|WATER
BAER-RXN.c	BAER-MONOMER|BAES-MONOMER|PHOSPHO-BAER|PHOSPHO-BAES
BAES-RXN.c	ADP|ATP|BAES-MONOMER|PHOSPHO-BAES
BARA-RXN.c	ADP|ATP|BARA-MONOMER|MONOMER0-4210
BAROMP-RXN.c	BARA-MONOMER|OMPR-MONOMER|PHOSPHO-BARA-HIS|PHOSPHO-OMPR
BASR-RXN.c	BASR-MONOMER|BASS-MONOMER|PHOSPHO-BASR|PHOSPHO-BASS
BASS-RXN.c	ADP|ATP|BASS-MONOMER|PHOSPHO-BASS
BETA-GLUCURONID-RXN.c	Alcohols|Beta-D-Glucuronides|WATER
BETA-LACTAMASE-RXN.p	Beta-Lactams|CPD-8550|WATER
BETA-PHOSPHOGLUCOMUTASE-RXN.c	CPD-448|GLC-6-P
BETAGALACTOSID-RXN.c	GALACTOSE|GLC|WATER
BIOTIN-CARBOXYL-RXN.c	ADP|ATP|BCCP-dimers|Carboxybiotin-BCCP|HCO3|PROTON|Pi
BIOTINLIG-RXN.c	AMP|ATP|BCCP-biotin-monomers|BCCP-monomers|BIOTIN|PPI
BRANCHED-CHAINAMINOTRANSFERILEU-RXN.c	2-KETO-3-METHYL-VALERATE|2-KETOGLUTARATE|GLT|ILE
BRANCHED-CHAINAMINOTRANSFERLEU-RXN.c	2-KETOGLUTARATE|2K-4CH3-PENTANOATE|GLT|LEU
BRANCHED-CHAINAMINOTRANSFERVAL-RXN.c	2-KETO-ISOVALERATE|2-KETOGLUTARATE|GLT|VAL
BTUR2-RXN.c	ADENOSYLCOBINAMIDE|ATP|COBINAMIDE|P3I
CARBAMATE-KINASE-RXN.c	ADP|AMMONIUM|ATP|CARBAMOYL-P|CARBON-DIOXIDE|PROTON
CARBOXYLESTERASE-RXN.c	Alcohols|Carboxylates|Carboxylic-esters|PROTON|WATER
CARBPSYN-RXN.c	ADP|ATP|CARBAMOYL-P|GLN|GLT|HCO3|PROTON|Pi|WATER
CARDIOLIPSYN-RXN.p	CARDIOLIPIN|GLYCEROL|L-1-PHOSPHATIDYL-GLYCEROL
CARNDETRU-RXN.c	CROTONOBETAINYL-COA|L-CARNITINYL-COA|WATER
CATAL-RXN.c	HYDROGEN-PEROXIDE|OXYGEN-MOLECULE|WATER
CDPDIGLYPYPHOSPHA-RXN.p	CDPDIACYLGLYCEROL|CMP|L-PHOSPHATIDATE|PROTON|WATER
CDPDIGLYSYN-RXN.p	CDPDIACYLGLYCEROL|CTP|L-PHOSPHATIDATE|PPI|PROTON
CDPKIN-RXN.c	ADP|ATP|CDP|CTP
CDPREDUCT-RXN.c	CDP|DCDP|Ox-Thioredoxin|Red-Thioredoxin|WATER
CHD-RXN.p	Acceptor|BETAINE_ALDEHYDE|CHOLINE|Donor-H2
CHEBDEAMID-RXN.c	AMMONIUM|Protein-L-glutamine|WATER
CHEBDEP-RXN.c	CHEB-MONOMER|PHOSPHO-CHEB|Pi
CHEBTAPD-RXN.c	AMMONIA|TAP-GLN|TAP-GLU|WATER
CHEBTARD-RXN.c	AMMONIA|TAR-GLN|TAR-GLU|WATER
CHEBTRGD-RXN.c	AMMONIA|TRG-GLN|TRG-GLU|WATER
CHEBTSRD-RXN.c	AMMONIA|TSR-GLN|TSR-GLU|WATER
CHER-RXN.c	ADENOSYL-HOMO-CYS|S-ADENOSYLMETHIONINE|protein-L-glutamate-O4-methyl-ester
CHER-RXN.p	ADENOSYL-HOMO-CYS|S-ADENOSYLMETHIONINE|protein-L-glutamate-O4-methyl-ester
CHERTAPM-RXN.c	ADENOSYL-HOMO-CYS|S-ADENOSYLMETHIONINE|TAP-GLU|TAP-GLUME
CHERTAPM-RXN.p	ADENOSYL-HOMO-CYS|S-ADENOSYLMETHIONINE|TAP-GLU|TAP-GLUME
CHERTARM-RXN.c	ADENOSYL-HOMO-CYS|S-ADENOSYLMETHIONINE|TAR-GLU|TAR-GLUME
CHERTARM-RXN.p	ADENOSYL-HOMO-CYS|S-ADENOSYLMETHIONINE|TAR-GLU|TAR-GLUME
CHERTRGM-RXN.c	ADENOSYL-HOMO-CYS|S-ADENOSYLMETHIONINE|TRG-GLU|TRG-GLUME
CHERTRGM-RXN.p	ADENOSYL-HOMO-CYS|S-ADENOSYLMETHIONINE|TRG-GLU|TRG-GLUME
CHERTSRM-RXN.c	ADENOSYL-HOMO-CYS|S-ADENOSYLMETHIONINE|TSR-GLU|TSR-GLUME
CHERTSRM-RXN.p	ADENOSYL-HOMO-CYS|S-ADENOSYLMETHIONINE|TSR-GLU|TSR-GLUME
CHEYDEPHOS-RXN.c	CHEY-MONOMER|PHOSPHO-CHEY|Pi|WATER
CHORISMATE-SYNTHASE-RXN.c	3-ENOLPYRUVYL-SHIKIMATE-5P|CHORISMATE|Pi
CHORISMATEMUT-RXN.c	CHORISMATE|PREPHENATE
CHORPYRLY-RXN.c	4-hydroxybenzoate|CHORISMATE|PYRUVATE
CITC-RXN.c	ACET|AMP|ATP|CITRATE-LYASE|HOLO-CITRATE-LYASE|PPI
CITLY-RXN.c	ACET|CIT|OXALACETIC_ACID
CITRATE-PRO-3S-LYASE-THIOLESTERASE-RXN.c	ACET|CITRATE-LYASE|HOLO-CITRATE-LYASE|WATER
CITRYLY-RXN.c	CITRATE-LYASE|OXALACETIC_ACID
CITSYN-RXN.c	ACETYL-COA|CIT|CO-A|OXALACETIC_ACID|PROTON|WATER
CITTRANS-RXN.c	ACET|CIT|CITRATE-LYASE
COBALADENOSYLTRANS-RXN.c	ADENOSYLCOBALAMIN|ATP|COB-I-ALAMIN|P3I
COBALAMIN5PSYN-RXN.p	ADENOSYLCOBALAMIN-5-P|ADENOSYLCOBINAMIDE-GDP|ALPHA-RIBAZOLE-5-P|GMP|PROTON
COBALAMINSYN-RXN.p	ADENOSYLCOBALAMIN|ADENOSYLCOBINAMIDE-GDP|ALPHA-RIBAZOLE|GMP|PROTON
COBINAMIDEKIN-RXN.c	ADENOSYLCOBINAMIDE|ADENOSYLCOBINAMIDE-P|ADP|ATP|PROTON
COBINPGUANYLYLTRANS-RXN.c	ADENOSYLCOBINAMIDE-GDP|ADENOSYLCOBINAMIDE-P|GTP|PPI|PROTON
CPM-KDOSYNTH-RXN.c	CMP-KDO|CTP|KDO|PPI
CPXA-RXN.c	ADP|ATP|CPXA-MONOMER|PHOSPHO-CPXA
CPXR-RXN.c	CPLX0-7748|CPXA-MONOMER|CPXR-MONOMER|PHOSPHO-CPXA
CREB-RXN.c	CREB-MONOMER|CREC-MONOMER|PHOSPHO-CREB|PHOSPHO-CREC
CREC-RXN.c	ADP|ATP|CREC-MONOMER|PHOSPHO-CREC
CROBETREDUCT-RXN.c	Acceptor|CROTONOBETAINYL-COA|Donor-H2|GAMMA-BUTYROBETAINYL-COA
CTPSYN-RXN.c	ADP|ATP|CTP|GLN|GLT|PROTON|Pi|UTP|WATER
CYCPHOSDIESTER-RXN.p	3-Prime-Ribonucleoside-Monophosphates|PROTON|WATER
CYSTATHIONINE-BETA-LYASE-RXN.c	AMMONIUM|HOMO-CYS|L-CYSTATHIONINE|PYRUVATE|WATER
CYSTEINE--TRNA-LIGASE-RXN.c	AMP|ATP|CYS|CYS-tRNAs|Charged-CYS-tRNAs|PPI|PROTON
CYSTEINE-AMINOTRANSFERASE-RXN.c	2-KETOGLUTARATE|3-MERCAPTO-PYRUVATE|CYS|GLT
CYT-ACC-RXN.c	Acceptor|Cytochromes-B|Cytochromes-B-Reduced|Donor-H2
CYTC-RED-RXN.c	Cytochromes-B|Cytochromes-B-Reduced|Reduced-Cytochromes-o
CYTD-OX-RXN.c	Cytochromes-D|Cytochromes-D-Reduced|OXYGEN-MOLECULE|PROTON|WATER
CYTD-RED-RXN.c	Cytochromes-B|Cytochromes-B-Reduced|Cytochromes-D|Cytochromes-D-Reduced
CYTDEAM-RXN.c	AMMONIUM|CYTOSINE|PROTON|URACIL|WATER
CYTIDEAM-RXN.c	AMMONIUM|DEOXYCYTIDINE|DEOXYURIDINE|PROTON|WATER
CYTIDEAM2-RXN.c	AMMONIUM|CYTIDINE|PROTON|URIDINE|WATER
CYTIDINEKIN-RXN.c	CMP|CYTIDINE|GDP|GTP|PROTON
CYTIKIN-RXN.c	ADP|ATP|CMP|CYTIDINE|PROTON
D--TARTRATE-DEHYDRATASE-RXN.c	D-TARTRATE|OXALACETIC_ACID|WATER
D-PPENTOMUT-RXN.c	DEOXY-D-RIBOSE-1-PHOSPHATE|DEOXY-RIBOSE-5P
DADPKIN-RXN.c	ADP|ATP|DADP|DATP
DAHPSYN-RXN.c	3-DEOXY-D-ARABINO-HEPTULOSONATE-7-P|ERYTHROSE-4P|PHOSPHO-ENOL-PYRUVATE|Pi|WATER
DALADALALIG-RXN.c	ADP|ATP|D-ALA-D-ALA|D-ALANINE|PROTON|Pi
DALADEHYDROG-RXN.p	AMMONIUM|D-ALANINE|ETR-Quinols|ETR-Quinones|PYRUVATE|WATER
DAPASYN-RXN.c	8-AMINO-7-OXONONANOATE|DIAMINONONANOATE|S-ADENOSYL-4-METHYLTHIO-2-OXOBUTANOATE|S-ADENOSYLMETHIONINE
DARAB5PISOM-RXN.c	ARABINOSE-5P|RIBULOSE-5P
DARABALDOL-RXN.c	D-RIBULOSE-1-P|DIHYDROXY-ACETONE-PHOSPHATE|GLYCOLALDEHYDE
DARABISOM-RXN.c	D-RIBULOSE
DARABKIN-RXN.c	ADP|ATP|D-RIBULOSE|D-RIBULOSE-1-P|PROTON
DCDPKIN-RXN.c	ADP|ATP|DCDP|DCTP
DCTP-DEAM-RXN.c	AMMONIUM|DCTP|DUTP|PROTON|WATER
DCTP-PYROPHOSPHATASE-RXN.c	DCMP|DCTP|PPI|PROTON|WATER
DCUS-RXN.c	ADP|ATP|DCUS-MONOMER|PHOSPHO-DCUS-MONOMER
DCYSDESULF-RXN.c	AMMONIUM|D-CYSTEINE|HS|PYRUVATE|WATER
DEHYDDEOXGALACTKIN-RXN.c	2-DEHYDRO-3-DEOXY-D-GALACTONATE|ADP|ATP|DEHYDRO-DEOXY-GALACTONATE-PHOSPHATE|PROTON
DEHYDDEOXPHOSGALACT-ALDOL-RXN.c	DEHYDRO-DEOXY-GALACTONATE-PHOSPHATE|GAP|PYRUVATE
DEOXYADENPHOSPHOR-RXN.c	ADENINE|DEOXY-D-RIBOSE-1-PHOSPHATE|DEOXYADENOSINE|Pi
DEOXYGLUCONOKIN-RXN.c	2-DEHYDRO-3-DEOXY-D-GLUCONATE|2-KETO-3-DEOXY-6-P-GLUCONATE|ADP|ATP|PROTON
DEOXYGUANPHOSPHOR-RXN.c	DEOXY-D-RIBOSE-1-PHOSPHATE|DEOXYGUANOSINE|GUANINE|Pi
DEOXYINOPHOSPHOR-RXN.c	DEOXY-D-RIBOSE-1-PHOSPHATE|DEOXYINOSINE|HYPOXANTHINE|Pi
DEOXYNUCLEOTIDE-3-PHOSPHATASE-RXN.p	Deoxy-Ribonucleosides|Pi|WATER
DEOXYRIBODIPYRIMIDINE-PHOTOLYASE-RXN.c	DNA-Adjacent-Pyrimidines
DEOXYRIBOSE-P-ALD-RXN.c	ACETALD|DEOXY-RIBOSE-5P|GAP
DEOXYRIBOSE-P-ALD-RXN.e	ACETALD|DEOXY-RIBOSE-5P|GAP
DEPHOSICITDEHASE-RXN.c	Iso-Cit|Pi|WATER|isocitrate-dehydrogenase
DEPHOSPHOCOAKIN-RXN.c	ADP|ATP|CO-A|DEPHOSPHO-COA|PROTON
DETHIOBIOTIN-SYN-RXN.c	ADP|ATP|CARBON-DIOXIDE|DETHIOBIOTIN|DIAMINONONANOATE|PROTON|Pi
DGDPKIN-RXN.c	ADP|ATP|DGDP|DGTP
DGTPTRIPHYDRO-RXN.c	DEOXYGUANOSINE|DGTP|P3I|PROTON|WATER
DHBAMPLIG-RXN.c	2-3-DIHYDROXYBENZOATE|ATP|CPD-62|PPI|PROTON
DHBAMPLIG-RXN.e	2-3-DIHYDROXYBENZOATE|ATP|CPD-62|PPI|PROTON
DHBDEHYD-RXN.c	2-3-DIHYDROXYBENZOATE|DIHYDRO-DIOH-BENZOATE|NAD|NADH|PROTON
DHDOGALDOL-RXN.c	2-DEHYDRO-3-DEOXY-D-GLUCONATE|GLYCERALD|PYRUVATE
DHHB-METHYLTRANSFER-RXN.c	ADENOSYL-HOMO-CYS|CPD-9956|OCTAPRENYL-METHYL-OH-METHOXY-BENZQ|PROTON|S-ADENOSYLMETHIONINE
DIACYLGLYKIN-RXN.c	ADP|ATP|DIACYLGLYCEROL|L-PHOSPHATIDATE|PROTON
DIAMACTRANS-RXN.c	ACETYL-COA|Aliphatic-Alpha-Omega-Diamines|Aliphatic-N-Acetyl-Diamines|CO-A|PROTON
DIAMINOPIMDECARB-RXN.c	CARBON-DIOXIDE|LYS|MESO-DIAMINOPIMELATE|PROTON
DIAMINOPIMEPIM-RXN.c	LL-DIAMINOPIMELATE|MESO-DIAMINOPIMELATE
DIAMTRANSAM-RXN.c	2-KETOGLUTARATE|Aliphatic-Alpha-Omega-Diamines|Aliphatic-Omega-Amino-Aldehydes|GLT
DIENOYLCOAREDUCT-RXN.c	NADP|NADPH|PROTON|T2-C4-DECADIENYL-COA|T2-DECENOYL-COA
DIHYDLIPACETRANS-RXN.c	ACETYL-COA|CO-A|DIHYDROLIPOAMIDE|S-ACETYLDIHYDROLIPOAMIDE
DIHYDRODIPICSYN-RXN.c	L-ASPARTATE-SEMIALDEHYDE|PROTON|PYRUVATE|WATER
DIHYDROFOLATEREDUCT-RXN.c	DIHYDROFOLATE|NADP|NADPH|PROTON|THF
DIHYDROFOLATESYNTH-RXN.c	7-8-DIHYDROPTEROATE|ADP|ATP|DIHYDROFOLATE|GLT|PROTON|Pi
DIHYDRONEOPTERIN-MONO-P-DEPHOS-RXN.c	DIHYDRO-NEO-PTERIN|DIHYDRONEOPTERIN-P|Pi|WATER
DIHYDROOROT-RXN.c	CARBAMYUL-L-ASPARTATE|DI-H-OROTATE|PROTON|WATER
DIHYDROURACIL-DEHYDROGENASE-NAD+-RXN.c	DI-H-URACIL|NAD|NADH|PROTON|URACIL
DIHYDROXYISOVALDEHYDRAT-RXN.c	2-KETO-ISOVALERATE|WATER
DIHYDROXYMETVALDEHYDRAT-RXN.c	1-KETO-2-METHYLVALERATE|2-KETO-3-METHYL-VALERATE|WATER
DIMESULFREDUCT-RXN.c	CPD-7670|DMSO|Menaquinols|Menaquinones|WATER
DIMESULFREDUCT-RXN.p	CPD-7670|DMSO|Menaquinols|Menaquinones|WATER
DIMETHUROPORDEHYDROG-RXN.c	DIHYDROSIROHYDROCHLORIN|NAD|NADH|PROTON|SIROHYDROCHLORIN
DIOHBUTANONEPSYN-RXN.c	DIHYDROXY-BUTANONE-P|FORMATE|PROTON|RIBULOSE-5P
DISULFOXRED-RXN.c	Protein-Ox-Disulfides|Protein-Red-Disulfides
DISULFOXRED-RXN.p	Protein-Ox-Disulfides|Protein-Red-Disulfides
DLACTDEHYDROGFAD-RXN.p	D-LACTATE|ETR-Quinols|ETR-Quinones|PYRUVATE
DLACTDEHYDROGNAD-RXN.c	D-LACTATE|NAD|NADH|PROTON|PYRUVATE
DMBPPRIBOSYLTRANS-RXN.c	ALPHA-RIBAZOLE-5-P|DIMETHYLBENZIMIDAZOLE|NIACINE|NICOTINATE_NUCLEOTIDE|PROTON
DMK-FE-RXN.c	FeS-Proteins|FeS-Proteins-Reduced|Ox-Demethylmenaquinone-Oxidoreductases|PROTON|Red-Demethylmenaquinol-Oxidoreductases
DMK-RXN.p	CARBON-DIOXIDE|CPD-12115|DIHYDROXYNAPHTHOATE|OCTAPRENYL-DIPHOSPHATE|PPI|PROTON
DMKCYT-RXN.c	Cytochromes-B|Cytochromes-B-Reduced|Ox-Demethylmenaquinone-Oxidoreductases|Red-Demethylmenaquinol-Oxidoreductases
DNA-CYTOSINE-5--METHYLTRANSFERASE-RXN.c	5-Methylcytosine-DNA|ADENOSYL-HOMO-CYS|DNA-Cytosines|PROTON|S-ADENOSYLMETHIONINE
DNA-DIRECTED-DNA-POLYMERASE-RXN.c	DNA-N|Deoxy-Ribonucleoside-Triphosphates|PPI
DNA-DIRECTED-RNA-POLYMERASE-RXN.c	Nucleoside-Triphosphates|PPI|RNA-Holder
DNA-LIGASE-NAD+-RXN.c	AMP|DEOXYNUCLEOTIDESM|DNA-N|NAD|NICOTINAMIDE_NUCLEOTIDE
DSBD-RXN.p	DSBD-MONOMER|DSBDOXI-MONOMER|DSBG-MONOMER
DSBDC-RXN.p	DSBD-MONOMER|DSBDOXI-MONOMER
DSERDEAM-RXN.c	AMMONIUM|D-SERINE|PYRUVATE
DTDPDEHYDRHAMEPIM-RXN.c	DTDP-DEOH-DEOXY-GLUCOSE|DTDP-DEOH-DEOXY-MANNOSE
DTDPDEHYRHAMREDUCT-RXN.c	DTDP-DEOH-DEOXY-MANNOSE|DTDP-RHAMNOSE|NADP|NADPH|PROTON
DTDPGLUCDEHYDRAT-RXN.c	DTDP-D-GLUCOSE|DTDP-DEOH-DEOXY-GLUCOSE|WATER
DTDPGLUCOSEPP-RXN.c	DTDP-D-GLUCOSE|GLC-1-P|PPI|PROTON|TTP
DTDPKIN-RXN.c	ADP|ATP|TDP|TTP
DTDPRHAMSYNTHMULTI-RXN.c	DTDP-DEOH-DEOXY-GLUCOSE|DTDP-RHAMNOSE|NAD|NADH|PROTON
DTMPKI-RXN.c	ADP|ATP|TDP|TMP
DUDPKIN-RXN.c	ADP|ATP|DUDP|DUTP
DURIDKI-RXN.c	ADP|ATP|DEOXYURIDINE|DUMP|PROTON
DUTP-PYROP-RXN.c	DUMP|DUTP|PPI|PROTON|WATER
DXPREDISOM-RXN.c	2-C-METHYL-D-ERYTHRITOL-4-PHOSPHATE|DEOXYXYLULOSE-5P|NADP|NADPH|PROTON
DXS-RXN.c	CARBON-DIOXIDE|DEOXYXYLULOSE-5P|GAP|PROTON|PYRUVATE
ENOYL-ACP-REDUCT-NADH-RXN.c	NAD|NADH|PROTON|Saturated-Fatty-Acyl-ACPs|TRANS-D2-ENOYL-ACP
ENOYL-ACP-REDUCT-NADPH-RXN.c	NADP|NADPH|PROTON|Saturated-Fatty-Acyl-ACPs|TRANS-D2-ENOYL-ACP
ENOYL-COA-DELTA-ISOM-RXN.c	CIS-DELTA3-ENOYL-COA|TRANS-D2-ENOYL-COA
ENOYL-COA-HYDRAT-RXN.c	L-3-HYDROXYACYL-COA|TRANS-D2-ENOYL-COA|WATER
ENTD-RXN.p	3-5-ADP|CO-A|ENTF-MONOMER|ENTF-PANT
ENTDB-RXN.p	3-5-ADP|APO-ENTB|Apo-Aryl-Carrier-Proteins|CO-A|ENTB-CPLX|Holo-Aryl-Carrier-Proteins
ENTF-RXN.c	ATP|PPI|SER|SERYL-AMP
ENTG-RXN.c	AMP|CPD-62|ENTEROBACTIN|PROTON|SERYL-AMP
ENTMULTI-RXN.c	2-3-DIHYDROXYBENZOATE|AMP|ATP|ENTEROBACTIN|PPI|PROTON|SER
ENVZ-RXN.ce	ADP|ATP|PHOSPHO-ENVZ
ERYTH4PDEHYDROG-RXN.c	ERYTHRONATE-4P|ERYTHROSE-4P|NAD|NADH|PROTON|WATER
ERYTHRON4PDEHYDROG-RXN.c	3OH-4P-OH-ALPHA-KETOBUTYRATE|ERYTHRONATE-4P|NAD|NADH|PROTON
ETHAMLY-RXN.c	ACETALD|AMMONIUM|ETHANOL-AMINE
EVGA-RXN.c	EVGA-MONOMER|EVGS-MONOMER|PHOSPHO-EVGA|PHOSPHO-EVGS
EXOPOLYPHOSPHATASE-RXN.c	Long-Chain-Polyphosphate|Pi|WATER
F16ALDOLASE-RXN.c	DIHYDROXY-ACETONE-PHOSPHATE|FRUCTOSE-16-DIPHOSPHATE|GAP
F16BDEPHOS-RXN.c	FRUCTOSE-16-DIPHOSPHATE|FRUCTOSE-6P|Pi|WATER
FAD-OX-RXN.c	FeS-Proteins-Reduced|Ox-FAD-Flavoproteins|PROTON|Red-FADH2-Flavoproteins
FAD-RED-RXN.c	NAD-P-OR-NOP|NADH-P-OR-NOP|Ox-FAD-Flavoproteins|Red-FADH2-Flavoproteins
FADSYN-RXN.c	ATP|FAD|FMN|PPI|PROTON
FERREDOXIN--NAD+-REDUCTASE-RXN.c	NAD|NADH|Oxidized-2Fe-2S-Ferredoxins|PROTON|Reduced-2Fe-2S-Ferredoxins
FES-OX-RXN.c	FeS-Proteins|FeS-Proteins-Reduced|Ox-Ubiquinone-8-Oxidoreductases|PROTON|Red-Ubiquinol-8-Oxidoreductases
FGAMSYN-RXN.c	5-P-RIBOSYL-N-FORMYLGLYCINEAMIDE|5-PHOSPHORIBOSYL-N-FORMYLGLYCINEAMIDINE|ADP|ATP|GLN|GLT|PROTON|Pi|WATER
FHLMULTI-RXN.c	CARBON-DIOXIDE|FORMATE|HYDROGEN-MOLECULE|PROTON
FLAVONADPREDUCT-RXN.c	NADP|NADPH|Oxidized-flavodoxins|PROTON|Reduced-flavodoxins
FMN-OX-RXN.c	FeS-Proteins|FeS-Proteins-Reduced|Ox-FMN-Flavoproteins|PROTON|Red-FMNH2-Flavoproteins
FMN-RED-RXN.c	NAD-P-OR-NOP|NADH-P-OR-NOP|Ox-FMN-Flavoproteins|Red-FMNH2-Flavoproteins
FMNREDUCT-RXN.c	FMN|FMNH2|NAD-P-OR-NOP|NADH-P-OR-NOP|PROTON
FOLYLPOLYGLUTAMATESYNTH-RXN.c	ADP|ATP|GLT|Pi|THF-GLU-N
FORMATEDEHYDROG-RXN.cp	CARBON-DIOXIDE|FORMATE|Menaquinols|Menaquinones|PROTON
FORMYLTHFDEFORMYL-RXN.c	10-FORMYL-THF|FORMATE|PROTON|THF|WATER
FORMYLTHFGLUSYNTH-RXN.c	ADP|ATP|FORMYL-THF-GLU-N|GLT|Pi
FPPSYN-RXN.c	DELTA3-ISOPENTENYL-PP|FARNESYL-PP|GERANYL-PP|PPI
FRUCTOKINASE-RXN.c	ADP|ATP|BETA-D-FRUCTOSE|FRUCTOSE-6P|PROTON
FUC4NACTRANS-RXN.p	C55-PP-GLCNAC-MANNACA|C55-PP-GLCNAC-MANNACA-FUC4NAC|PROTON|TDP|TDP-FUC4NAC
FUCISOM-RXN.c	L-FUCULOSE
FUCPALDOL-RXN.c	DIHYDROXY-ACETONE-PHOSPHATE|FUCULOSE-1P|LACTALD
FUCULOKIN-RXN.c	ADP|ATP|FUCULOSE-1P|L-FUCULOSE|PROTON
FUMHYDR-RXN.c	FUM|MAL|WATER
GABATRANSAM-RXN.c	2-KETOGLUTARATE|4-AMINO-BUTYRATE|GLT|SUCC-S-ALD
GALACTARDEHYDRA-RXN.c	5-KETO-4-DEOXY-D-GLUCARATE|D-GALACTARATE|WATER
GALACTITOLPDEHYD-RXN.c	GALACTITOL-1-PHOSPHATE|NAD|NADH|PROTON|TAGATOSE-6-PHOSPHATE
GALACTOACETYLTRAN-RXN.c	6-Acetyl-Beta-D-Galactosides|ACETYL-COA|Beta-D-Galactosides|CO-A
GALACTOKIN-RXN.c	ADP|ALPHA-D-GALACTOSE|ATP|GALACTOSE-1P|PROTON
GALACTONDEHYDRAT-RXN.c	2-DEHYDRO-3-DEOXY-D-GALACTONATE|D-GALACTONATE|WATER
GALACTONOLACTONASE-RXN.c	D-GALACTONATE|D-GALACTONO-1-4-LACTONE|PROTON|WATER
GALACTURIDYLYLTRANS-RXN.c	GALACTOSE-1P|GLC-1-P
GALACTUROISOM-RXN.c	D-TAGATURONATE
GALPMUT-RXN.c	UDP-D-GALACTO-14-FURANOSE
GAMMA-GLUTAMYLTRANSFERASE-RXN.p	5-L-GLUTAMYL-PEPTIDE
GAPOXNPHOSPHN-RXN.c	DPG|GAP|NAD|NADH|PROTON|Pi
GART-RXN.c	10-FORMYL-THF|5-P-RIBOSYL-N-FORMYLGLYCINEAMIDE|5-PHOSPHO-RIBOSYL-GLYCINEAMIDE|PROTON|THF
GARTRANSFORMYL2-RXN.c	5-P-RIBOSYL-N-FORMYLGLYCINEAMIDE|5-PHOSPHO-RIBOSYL-GLYCINEAMIDE|ADP|ATP|FORMATE|PROTON|Pi
GCVMULTI-RXN.c	AMMONIUM|CARBON-DIOXIDE|GLY|METHYLENE-THF|NAD|NADH|THF
GCVP-RXN.c	AMINOMETHYLDIHYDROLIPOYL-GCVH|CARBON-DIOXIDE|GLY|PROTEIN-LIPOYLLYSINE
GCVT-RXN.c	AMINOMETHYLDIHYDROLIPOYL-GCVH|AMMONIUM|DIHYDROLIPOYL-GCVH|METHYLENE-THF|THF
GDP-GLUCOSIDASE-RXN.c	GDP|GDP-D-GLUCOSE|GLC|PROTON|WATER
GDPKIN-RXN.c	ADP|ATP|GDP|GTP
GDPMANDEHYDRA-RXN.c	GDP-4-DEHYDRO-6-DEOXY-D-MANNOSE|GDP-MANNOSE|WATER
GDPMANMANHYDRO-RXN.c	GDP|GDP-MANNOSE|MANNOSE|PROTON|WATER
GDPPYPHOSKIN-RXN.c	AMP|ATP|GDP|GUANOSINE-5DP-3DP
GDPREDUCT-RXN.c	DGDP|GDP|Ox-Thioredoxin|Red-Thioredoxin|WATER
GKI-RXN.c	2-PG|ADP|ATP|GLYCERATE|PROTON
GLCNACPTRANS-RXN.c	ACETYL-D-GLUCOSAMINYLDIPHOSPHO-UNDECAPRE|CPD-9646|UDP-N-ACETYL-D-GLUCOSAMINE|UMP
GLU6PDEHYDROG-RXN.c	D-6-P-GLUCONO-DELTA-LACTONE|GLC-6-P|NADP|NADPH|PROTON
GLUC1PADENYLTRANS-RXN.c	ADP-D-GLUCOSE|ATP|GLC-1-P|PPI|PROTON
GLUC1PURIDYLTRANS-RXN.c	GLC-1-P|PPI|PROTON|UTP
GLUCARDEHYDRA-RXN.c	5-KETO-4-DEOXY-D-GLUCARATE|D-GLUCARATE|WATER
GLUCDEHYDROG-RXN.c	GLC|GLC-D-LACTONE|Ubiquinols|Ubiquinones
GLUCOKIN-RXN.c	ADP|ATP|GLC|GLC-6-P|PROTON
GLUCONATE-5-DEHYDROGENASE-RXN.c	5-DEHYDROGLUCONATE|GLUCONATE|NAD-P-OR-NOP|NADH-P-OR-NOP|PROTON
GLUCONOKIN-RXN.c	ADP|ATP|CPD-2961|GLUCONATE|PROTON
GLUCONOLACT-RXN.c	GLC-D-LACTONE|GLUCONATE|PROTON|WATER
GLUCOSAMINE-6-P-DEAMIN-RXN.c	AMMONIUM|D-GLUCOSAMINE-6-P|FRUCTOSE-6P|WATER
GLUCOSE-1-PHOSPHAT-RXN.c	GLC-1-P|Pi|WATER
GLUCOSE-1-PHOSPHAT-RXN.p	GLC-1-P|Pi|WATER
GLUCOSE-6-PHOSPHATASE-RXN.c	GLC|GLC-6-P|Pi|WATER
GLUCOSE-6-PHOSPHATE-1-EPIMERASE-RXN.c	ALPHA-GLC-6-P|GLC-6-P
GLUCUROISOM-RXN.c	FRUCTURONATE
GLURS-RXN.c	AMP|ATP|Charged-GLT-tRNAs|GLT|GLT-tRNAs|PPI|PROTON
GLUTAMATESYN-RXN.c	2-KETOGLUTARATE|GLN|GLT|NADP|NADPH|PROTON
GLUTAMIDOTRANS-RXN.c	AICAR|D-ERYTHRO-IMIDAZOLE-GLYCEROL-P|GLN|GLT|PHOSPHORIBULOSYL-FORMIMINO-AICAR-P|PROTON
GLUTAMIN-RXN.c	AMMONIUM|GLN|GLT|WATER
GLUTAMINE--TRNA-LIGASE-RXN.c	AMP|ATP|Charged-GLN-tRNAs|GLN|GLN-tRNAs|PPI|PROTON
GLUTAMINESYN-RXN.c	ADP|AMMONIUM|ATP|GLN|GLT|PROTON|Pi
GLUTAREDOXIN-RXN.c	E-|Ox-Glutaredoxins|Red-Glutaredoxins
GLUTATHIONE-PEROXIDASE-RXN.p	GLUTATHIONE|HYDROGEN-PEROXIDE|OXIDIZED-GLUTATHIONE|WATER
GLUTATHIONE-REDUCT-NADPH-RXN.c	GLUTATHIONE|NADP|NADPH|OXIDIZED-GLUTATHIONE|PROTON
GLUTATHIONE-SYN-RXN.c	ADP|ATP|GLUTATHIONE|GLY|L-GAMMA-GLUTAMYLCYSTEINE|PROTON|Pi
GLUTCYSLIG-RXN.c	ADP|ATP|CYS|GLT|L-GAMMA-GLUTAMYLCYSTEINE|PROTON|Pi
GLUTDECARBOX-RXN.c	4-AMINO-BUTYRATE|CARBON-DIOXIDE|GLT|PROTON
GLUTDEHYD-RXN.c	2-KETOGLUTARATE|AMMONIUM|GLT|NADP|NADPH|PROTON|WATER
GLUTKIN-RXN.c	ADP|ATP|GLT|L-GLUTAMATE-5-P
GLUTRACE-RXN.c	D-GLT|GLT
GLUTRNAREDUCT-RXN.c	Charged-GLT-tRNAs|GLT-tRNAs|GLUTAMATE-1-SEMIALDEHYDE|NADP|NADPH
GLUTSEMIALDEHYDROG-RXN.c	L-GLUTAMATE-5-P|L-GLUTAMATE_GAMMA-SEMIALDEHYDE|NADP|NADPH|PROTON|Pi
GLY3KIN-RXN.c	ADP|ATP|G3P|GLYCERATE|PROTON
GLYC3PDEHYDROGBIOSYN-RXN.c	DIHYDROXY-ACETONE-PHOSPHATE|GLYCEROL-3P|NAD-P-OR-NOP|NADH-P-OR-NOP|PROTON
GLYCDEH-RXN.c	DIHYDROXYACETONE|GLYCEROL|NAD|NADH|PROTON
GLYCEROL-1-PHOSPHATASE-RXN.c	GLYCEROL|Glycerol-1-phosphate|Pi|WATER
GLYCEROL-2-PHOSPHATASE-RXN.c	CPD-536|GLYCEROL|Pi|WATER
GLYCEROL-KIN-RXN.c	ADP|ATP|GLYCEROL|GLYCEROL-3P|PROTON
GLYCINE--TRNA-LIGASE-RXN.c	AMP|ATP|Charged-GLY-tRNAs|GLY|GLY-tRNAs|PPI|PROTON
GLYCOGEN-BRANCH-RXN.c	1-4-alpha-D-Glucan|Glycogens
GLYCOGENSYN-RXN.c	1-4-alpha-D-Glucan|ADP|ADP-D-GLUCOSE
GLYCOLALD-DEHYDROG-RXN.c	GLYCOLALDEHYDE|GLYCOLLATE|NAD|NADH|PROTON|WATER
GLYCOLALDREDUCT-RXN.c	GLYCOL|GLYCOLALDEHYDE|NAD|NADH|PROTON
GLYCOLATEDEHYDRO-RXN.c	Acceptor|Donor-H2|GLYCOLLATE|GLYOX
GLYCOPHOSPHORYL-RXN.c	CPD0-971|GLC-1-P|Glycogens|Pi
GLYCPDIESTER-RXN.c	Alcohols|GLYCEROL-3P|Glycerophosphodiesters|PROTON|WATER
GLYOCARBOLIG-RXN.c	CARBON-DIOXIDE|GLYOX|PROTON|TARTRONATE-S-ALD
GLYOHMETRANS-RXN.c	GLY|METHYLENE-THF|SER|THF|WATER
GLYOXI-RXN.c	GLUTATHIONE|METHYL-GLYOXAL|S-LACTOYL-GLUTATHIONE
GLYOXII-RXN.c	D-LACTATE|GLUTATHIONE|PROTON|S-LACTOYL-GLUTATHIONE|WATER
GLYOXIII-RXN.c	D-LACTATE|METHYL-GLYOXAL|PROTON|WATER
GLYOXYLATE-REDUCTASE-NADP+-RXN.c	GLYCOLLATE|GLYOX|NADP|NADPH|PROTON
GLYOXYLATE-REDUCTASE-NADP+-RXN.p	GLYCOLLATE|GLYOX|NADP|NADPH|PROTON
GLYRIBONUCSYN-RXN.c	5-P-BETA-D-RIBOSYL-AMINE|5-PHOSPHO-RIBOSYL-GLYCINEAMIDE|ADP|ATP|GLY|PROTON|Pi
GMKALT-RXN.c	ADP|ATP|DGDP|DGMP
GMP-REDUCT-RXN.c	AMMONIUM|GMP|IMP|NADP|NADPH|PROTON
GMP-SYN-GLUT-RXN.c	AMP|ATP|GLN|GLT|GMP|PPI|PROTON|WATER|XANTHOSINE-5-PHOSPHATE
GMP-SYN-NH3-RXN.c	AMMONIUM|AMP|ATP|GMP|PPI|PROTON|XANTHOSINE-5-PHOSPHATE
GPH-RXN.c	CPD-67|GLYCOLLATE|Pi|WATER
GPPSYN-RXN.c	CPD-4211|DELTA3-ISOPENTENYL-PP|GERANYL-PP|PPI
GSAAMINOTRANS-RXN.c	5-AMINO-LEVULINATE|GLUTAMATE-1-SEMIALDEHYDE
GSADENYLATION-RXN.c	ATP|Adenylyl-glutamine-synthases|Glutamine-synthases|PPI
GSDEADENYLATION-RXN.c	ADP|Adenylyl-glutamine-synthases|Glutamine-synthases|Pi
GSPAMID-RXN.c	GLUTATHIONE|GLUTATHIONYLSPERMIDINE|SPERMIDINE|WATER
GSPSYN-RXN.c	ADP|ATP|GLUTATHIONE|GLUTATHIONYLSPERMIDINE|PROTON|Pi|SPERMIDINE
GST-RXN.c	1-CHLORO-24-DINITROBENZENE|CL-|GLUTATHIONE|PROTON|S-24-DINITROPHENYLGLUTATHIONE
GTP-CYCLOHYDRO-I-RXN.c	DIHYDRONEOPTERIN-P3|FORMATE|GTP|PROTON|WATER
GTP-CYCLOHYDRO-II-RXN.c	DIAMINO-OH-PHOSPHORIBOSYLAMINO-PYR|FORMATE|GTP|PPI|PROTON|WATER
GTPPYPHOSKIN-RXN.c	AMP|ATP|GDP-TP|GTP
GUANINE-DEAMINASE-RXN.c	AMMONIUM|GUANINE|PROTON|WATER|XANTHINE
GUANOSINE-DIPHOSPHATASE-RXN.c	GDP|GMP|PROTON|Pi|WATER
GUANOSINEKIN-RXN.c	ADP|ATP|GMP|GUANOSINE|PROTON
GUANPRIBOSYLTRAN-RXN.c	GMP|GUANINE|PPI|PRPP
GUANYL-KIN-RXN.c	ADP|ATP|GDP|GMP
GUANYLCYC-RXN.c	CGMP|GTP|PPI
H2NEOPTERINALDOL-RXN.c	AMINO-OH-HYDROXYMETHYL-DIHYDROPTERIDINE|DIHYDRO-NEO-PTERIN|GLYCOLALDEHYDE
H2NEOPTERINP3PYROPHOSPHOHYDRO-RXN.c	DIHYDRONEOPTERIN-P|DIHYDRONEOPTERIN-P3|PPI|PROTON|WATER
H2NTPEPIM-RXN.c	DIHYDROMONAPTERIN-TRIPHOSPHATE|DIHYDRONEOPTERIN-P3
H2PTERIDINEPYROPHOSPHOKIN-RXN.c	AMINO-OH-HYDROXYMETHYL-DIHYDROPTERIDINE|AMP|ATP|DIHYDROPTERIN-CH2OH-PP|PROTON
H2PTEROATESYNTH-RXN.c	7-8-DIHYDROPTEROATE|DIHYDROPTERIN-CH2OH-PP|P-AMINO-BENZOATE|PPI
HCAMULTI-RXN.c	3-PHENYLPROPIONATE|CARBOXYETHYL-3-5-CYCLOHEXADIENE-1-2-DIOL|NAD|NADH|OXYGEN-MOLECULE|PROTON
HEMEOSYN-RXN.p	FARNESYL-PP|HEME_O|PPI|PROTOHEME|WATER
HEMN-RXN.c	CARBON-DIOXIDE|CH33ADO|COPROPORPHYRINOGEN_III|MET|PROTOPORPHYRINOGEN|S-ADENOSYLMETHIONINE
HISTALDEHYD-RXN.c	HIS|HISTIDINAL|NAD|NADH|PROTON|WATER
HISTAMINOTRANS-RXN.c	2-KETOGLUTARATE|GLT|IMIDAZOLE-ACETOL-P|L-HISTIDINOL-P
HISTCYCLOHYD-RXN.c	PHOSPHORIBOSYL-AMP|PHOSPHORIBOSYL-FORMIMINO-AICAR-P|WATER
HISTIDINE--TRNA-LIGASE-RXN.c	AMP|ATP|Charged-HIS-tRNAs|HIS|HIS-tRNAs|PPI|PROTON
HISTIDPHOS-RXN.c	HISTIDINOL|L-HISTIDINOL-P|Pi|WATER
HISTOLDEHYD-RXN.c	HISTIDINAL|HISTIDINOL|NAD|NADH|PROTON
HISTPRATPHYD-RXN.c	PHOSPHORIBOSYL-AMP|PHOSPHORIBOSYL-ATP|PPI|PROTON|WATER
HOLO-ACP-SYNTH-RXN.c	3-5-ADP|ACP|CO-A|apo-ACP
HOMOCYSMET-RXN.c	CPD-1301|CPD-1302|HOMO-CYS|MET
HOMOCYSMETB12-RXN.c	5-METHYL-THF|HOMO-CYS|MET|THF
HOMOCYSTEINE-S-METHYLTRANSFERASE-RXN.c	ADENOSYL-HOMO-CYS|HOMO-CYS|MET|PROTON|S-ADENOSYLMETHIONINE
HOMOSERDEHYDROG-RXN.c	HOMO-SER|L-ASPARTATE-SEMIALDEHYDE|NAD-P-OR-NOP|NADH-P-OR-NOP|PROTON
HOMOSERKIN-RXN.c	ADP|ATP|HOMO-SER|O-PHOSPHO-L-HOMOSERINE|PROTON
HOMSUCTRAN-RXN.c	CO-A|HOMO-SER|O-SUCCINYL-L-HOMOSERINE|SUC-COA
HYDG-RXN.c	HYDG-MONOMER|HYDH-MONOMER|PHOSPHO-HYDG|PHOSPHO-HYDH
HYDGLUTSYN-RXN.c	2-HYDROXYGLUTARIC_ACID|CO-A|GLYOX|PROPIONYL-COA|PROTON|WATER
HYDH-RXN.c	ADP|ATP|HYDH-MONOMER|PHOSPHO-HYDH
HYDROXYLAMINE-REDUCTASE-RXN.c	AMMONIUM|Acceptor|Donor-H2|HYDROXYLAMINE|PROTON|WATER
HYPOXANPRIBOSYLTRAN-RXN.c	HYPOXANTHINE|IMP|PPI|PRPP
IGPSYN-RXN.c	CARBON-DIOXIDE|CARBOXYPHENYLAMINO-DEOXYRIBULOSE-P|INDOLE-3-GLYCEROL-P|PROTON|WATER
IMIDPHOSDEHYD-RXN.c	D-ERYTHRO-IMIDAZOLE-GLYCEROL-P|IMIDAZOLE-ACETOL-P|WATER
IMP-DEHYDROG-RXN.c	IMP|NAD|NADH|PROTON|WATER|XANTHOSINE-5-PHOSPHATE
IMPCYCLOHYDROLASE-RXN.c	IMP|PHOSPHORIBOSYL-FORMAMIDO-CARBOXAMIDE|WATER
INOPHOSPHOR-RXN.c	HYPOXANTHINE|INOSINE|Pi|RIBOSE-1P
INORGPYROPHOSPHAT-RXN.c	PPI|PROTON|Pi|WATER
INOSINE-NUCLEOSIDASE-RXN.c	HYPOXANTHINE|INOSINE|WATER
INOSINEKIN-RXN.c	ADP|ATP|IMP|INOSINE|PROTON
IPPISOM-RXN.c	CPD-4211|DELTA3-ISOPENTENYL-PP
ISOCHORMAT-RXN.c	DIHYDRO-DIOH-BENZOATE|ISOCHORISMATE|PYRUVATE|WATER
ISOCHORSYN-RXN.c	CHORISMATE|ISOCHORISMATE
ISOCIT-CLEAV-RXN.c	GLYOX|SUC|THREO-DS-ISO-CITRATE
ISOCITDEH-RXN.c	2-KETOGLUTARATE|CARBON-DIOXIDE|NADP|NADPH|THREO-DS-ISO-CITRATE
ISOLEUCINE--TRNA-LIGASE-RXN.c	AMP|ATP|Charged-ILE-tRNAs|ILE|ILE-tRNAs|PPI|PROTON
ISPH2-RXN.c	DELTA3-ISOPENTENYL-PP|HYDROXY-METHYL-BUTENYL-DIP|NAD-P-OR-NOP|NADH-P-OR-NOP|PROTON|WATER
KDGALDOL-RXN.c	5-KETO-4-DEOXY-D-GLUCARATE|PYRUVATE|TARTRONATE-S-ALD
KDO-8PPHOSPHAT-RXN.c	KDO|KDO-8P|Pi|WATER
KDO-8PSYNTH-RXN.c	ARABINOSE-5P|KDO-8P|PHOSPHO-ENOL-PYRUVATE|Pi|WATER
KDOTRANS-RXN.p	CMP|CMP-KDO|KDO-LIPID-IVA|LIPID-IV-A|PROTON
KDOTRANS2-RXN.p	CMP|CMP-KDO|KDO-LIPID-IVA|KDO2-LIPID-IVA|PROTON
KDPD-RXN.c	ADP|ATP|KDPD-MONOMER|PHOSPHO-KDPD
KDPGALDOL-RXN.c	2-KETO-3-DEOXY-6-P-GLUCONATE|GAP|PYRUVATE
KDUD-RXN.c	DE-O-GLUCONATE|DE-O-K-GLUCONATE|NAD|NADH|PROTON
KETOACYLCOATHIOL-RXN.c	3-KETOACYL-COA|ACETYL-COA|CO-A|Saturated-Fatty-Acyl-CoA
KETOBUTFORMLY-RXN.c	2-OXOBUTANOATE|CO-A|FORMATE|PROPIONYL-COA
L-ASPARTATE-OXID-RXN.c	HYDROGEN-PEROXIDE|IMINOASPARTATE|L-ASPARTATE|OXYGEN-MOLECULE|PROTON
L-GLN-FRUCT-6-P-AMINOTRANS-RXN.c	D-GLUCOSAMINE-6-P|FRUCTOSE-6P|GLN|GLT
L-LACTDEHYDROGFMN-RXN.p	Acceptor|Donor-H2|L-LACTATE|PYRUVATE
L-RHAMNONATE-DEHYDRATASE-RXN.c	DEHYDRO-3-DEOXY-L-RHAMNONATE|L-RHAMNONATE|WATER
LACTALDDEHYDROG-RXN.c	L-LACTATE|LACTALD|NAD|NADH|PROTON|WATER
LACTALDREDUCT-RXN.c	LACTALD|NAD|NADH|PROPANE-1-2-DIOL|PROTON
LAUROYLACYLTRAN-RXN.p	ACP|Dodecanoyl-ACPs|KDO2-LAUROYL-LIPID-IVA|KDO2-LIPID-IVA
LCARNCOALIG-RXN.c	AMP|ATP|CARNITINE|CO-A|L-CARNITINYL-COA|PPI
LCYSDESULF-RXN.c	AMMONIUM|CYS|HS|PYRUVATE|WATER
LEUCINE--TRNA-LIGASE-RXN.c	AMP|ATP|Charged-LEU-tRNAs|LEU|LEU-tRNAs|PPI|PROTON
LEUCYLTRANSFERASE-RXN.c	Charged-LEU-tRNAs|General-Protein-Substrates|L-leucyl-protein|LEU-tRNAs|PROTON
LIPIDADISACCHARIDESYNTH-RXN.c	BISOHMYR-GLC|BISOHMYR-GLUCOSAMINYL-1P|OH-MYRISTOYL|PROTON|UDP
LIPIDXSYNTHESIS-RXN.c	BISOHMYR-GLUCOSAMINYL-1P|OH-MYRISTOYL|PROTON|UMP|WATER
LIPIDXSYNTHESIS-RXN.p	BISOHMYR-GLUCOSAMINYL-1P|OH-MYRISTOYL|PROTON|UMP|WATER
LTAA-RXN.c	ACETALD|GLY|L-ALLO-THREONINE
LTARTDEHYDRA-RXN.c	OXALACETIC_ACID|TARTRATE|WATER
LUMAZINESYN-RXN.c	AMINO-RIBOSYLAMINO-1H-3H-PYR-DIONE|DIHYDROXY-BUTANONE-P|DIMETHYL-D-RIBITYL-LUMAZINE|PROTON|Pi|WATER
LXULRU5P-RXN.c	L-RIBULOSE-5-P|L-XYLULOSE-5-P
LYSDECARBOX-RXN.c	CADAVERINE|CARBON-DIOXIDE|LYS|PROTON
LYSINE--TRNA-LIGASE-RXN.c	AMP|ATP|Charged-LYS-tRNAs|LYS|LYS-tRNAs|PPI|PROTON
LYSOPHOSPHOLIPASE-RXN.c	2-Acylglycero-Phosphocholines|Carboxylates|L-1-GLYCERO-PHOSPHORYLCHOLINE|PROTON|WATER
LYSOPHOSPHOLIPASE-RXN.p	2-Acylglycero-Phosphocholines|Carboxylates|L-1-GLYCERO-PHOSPHORYLCHOLINE|PROTON|WATER
LYXISOM-RXN.c	L-LYXOSE|L-XYLULOSE
LYXK-RXN.c	ADP|ATP|L-XYLULOSE|L-XYLULOSE-5-P|PROTON
MALATE-DEH-RXN.c	MAL|NAD|NADH|OXALACETIC_ACID|PROTON
MALATE-DEHYDROGENASE-ACCEPTOR-RXN.p	MAL|OXALACETIC_ACID|Quinones|Reduced-Quinones
MALIC-NADP-RXN.c	CARBON-DIOXIDE|MAL|NADP|NADPH|PYRUVATE
MALONYL-ACPDECARBOX-RXN.c	ACETYL-ACP|CARBON-DIOXIDE|MALONYL-ACP|PROTON
MALONYL-COA-ACP-TRANSACYL-RXN.c	ACP|CO-A|MALONYL-ACP|MALONYL-COA
MALSYN-RXN.c	ACETYL-COA|CO-A|GLYOX|MAL|PROTON|WATER
MALTACETYLTRAN-RXN.c	ACETYL-COA|ACETYLMALTOSE|CO-A|MALTOSE
MALTODEG-RXN.c	CPD0-1133|GLC|MALTOHEXAOSE|MALTOSE
MALTODEXGLUCOSID-RXN.c	1-4-alpha-D-Glucan|ALPHA-GLUCOSE|WATER
MANNKIN-RXN.c	ADP|ATP|MANNOSE-6P|PROTON
MANNONDEHYDRAT-RXN.c	2-DEHYDRO-3-DEOXY-D-GLUCONATE|D-MANNONATE|WATER
MANNONOXIDOREDUCT-RXN.c	D-MANNONATE|FRUCTURONATE|NAD|NADH|PROTON
MANNPDEHYDROG-RXN.c	FRUCTOSE-6P|MANNITOL-1P|NAD|NADH|PROTON
MANNPISOM-RXN.c	FRUCTOSE-6P|MANNOSE-6P
MCPMETEST-RXN.c	METOH|PROTON|WATER|protein-L-glutamate-O4-methyl-ester
MCPTAP-RXN.c	METOH|TAP-GLU|TAP-GLUME|WATER
MCPTAR-RXN.c	METOH|TAR-GLU|TAR-GLUME|WATER
MCPTRG-RXN.c	METOH|TRG-GLU|TRG-GLUME|WATER
MCPTSR-RXN.c	METOH|TSR-GLU|TSR-GLUME|WATER
MEN-FE-RXN.c	FeS-Proteins|FeS-Proteins-Reduced|Ox-Menaquinone-8-Oxidoreductases|PROTON|Red-Menaquinol-8-Oxidoreductases
MENCYT-RXN.c	Cytochromes-B|Cytochromes-B-Reduced|Ox-Menaquinone-8-Oxidoreductases|Red-Menaquinol-8-Oxidoreductases
MERCAPYSTRANS-RXN.c	3-MERCAPTO-PYRUVATE|HCN|HSCN|PROTON|PYRUVATE
METBALT-RXN.c	2-OXOBUTANOATE|AMMONIUM|O-SUCCINYL-L-HOMOSERINE|PROTON|SUC|WATER
METHENYLTHFCYCLOHYDRO-RXN.c	10-FORMYL-THF|5-10-METHENYL-THF|PROTON|WATER
METHGLYSYN-RXN.c	DIHYDROXY-ACETONE-PHOSPHATE|METHYL-GLYOXAL|Pi
METHIONINE--TRNA-LIGASE-RXN.c	AMP|ATP|Charged-MET-tRNAs|MET|MET-tRNAs|PPI|PROTON
METHIONYL-TRNA-FORMYLTRANSFERASE-RXN.c	10-FORMYL-THF|L-methionyl-tRNAfmet|N-formyl-L-methionyl-tRNAfmet|THF
METHYLENETHFDEHYDROG-NADP-RXN.c	5-10-METHENYL-THF|METHYLENE-THF|NADP|NADPH
METHYLISOCITRATE-LYASE-RXN.c	CPD-618|PYRUVATE|SUC
METHYLMALONYL-COA-EPIM-RXN.c	D-METHYL-MALONYL-COA|METHYL-MALONYL-COA
METHYLMALONYL-COA-MUT-RXN.c	METHYL-MALONYL-COA|SUC-COA
METHYLTHIOADENOSINE-NUCLEOSIDASE-RXN.c	5-METHYLTHIOADENOSINE|ADENINE|CPD-560|WATER
MHPCHYDROL-RXN.c	CPD-157|PROTON|SUC|WATER
MHPELY-RXN.c	4-HYDROXY-2-KETOVALERATE|ACETALD|PYRUVATE
MHPHYDROXY-RXN.c	2-3-DIHYDROXYPHENYL-PROPIONATE|3-HYDROXYPHENYL-PROPIONATE|NAD|NADH|OXYGEN-MOLECULE|PROTON|WATER
MMUM-RXN.c	CPD-397|HOMO-CYS|MET|PROTON
MYRISTOYLACYLTRAN-RXN.p	ACP|KDO2-LAUROYL-LIPID-IVA|KDO2-LIPID-A|Myristoyl-ACPs
MYRPALMTRAN-RXN.p	ACP|KDO2-LIPID-IVA-COLD|KDO2-PALMITOLEOYL-LIPID-IVA|Myristoyl-ACPs
N-ACETYLGLUCOSAMINE-KINASE-RXN.c	ADP|ATP|N-ACETYL-D-GLUCOSAMINE|N-ACETYL-D-GLUCOSAMINE-6-P|PROTON
N-ACETYLGLUTPREDUCT-RXN.c	CPD-469|N-ACETYL-GLUTAMYL-P|NADP|NADPH|PROTON|Pi
N-ACETYLTRANSFER-RXN.c	ACETYL-COA|ACETYL-GLU|CO-A|GLT|PROTON
NACGLCTRANS-RXN.p	C5|C6|PROTON|UDP|UDP-N-ACETYL-D-GLUCOSAMINE
NAD-KIN-RXN.c	ADP|ATP|NAD|NADP|PROTON
NAD-SYNTH-GLN-RXN.c	AMP|ATP|DEAMIDO-NAD|GLN|GLT|NAD|PPI|PROTON|WATER
NAD-SYNTH-NH3-RXN.c	AMMONIUM|AMP|ATP|DEAMIDO-NAD|NAD|PPI|PROTON
NADH-DEHYDROG-A-RXN.cp	NAD|NADH|PROTON|Ubiquinols|Ubiquinones
NADH-DEHYDROGENASE-QUINONE-RXN.c	CPD-3766|MENADIOL|NAD|NADH|PROTON
NADNUCLEOSID-RXN.e	ADENOSINE_DIPHOSPHATE_RIBOSE|NAD|NIACINAMIDE|PROTON|WATER
NADPH-DEHYDROGENASE-FLAVIN-RXN.c	CPD-316|NADP|NADPH|PROTON|RIBOFLAVIN
NADPYROPHOSPHAT-RXN.c	AMP|NAD|NICOTINAMIDE_NUCLEOTIDE|PROTON|WATER
NAG1P-URIDYLTRANS-RXN.c	N-ACETYL-D-GLUCOSAMINE-1-P|PPI|PROTON|UDP-N-ACETYL-D-GLUCOSAMINE|UTP
NAG6PDEACET-RXN.c	ACET|D-GLUCOSAMINE-6-P|N-ACETYL-D-GLUCOSAMINE-6-P|WATER
NANE-RXN.c	N-ACETYL-D-GLUCOSAMINE-6-P|N-ACETYL-D-MANNOSAMINE-6P
NANK-RXN.c	ADP|ATP|N-ACETYL-D-MANNOSAMINE-6P|PROTON
NAPHTHOATE-SYN-RXN.c	CPD-6972|CPD-9925|PROTON|WATER
NARLQ-RXN.c	NARL-MONOMER|NARQ-MONOMER|PHOSPHO-NARL|PHOSPHO-NARQ
NARLX-RXN.c	NARL-MONOMER|NARX-MONOMER|PHOSPHO-NARL|PHOSPHO-NARX
NARPQ-RXN.c	NARP-MONOMER|NARQ-MONOMER|PHOSPHO-NARP|PHOSPHO-NARQ
NARPX-RXN.c	NARP-MONOMER|NARX-MONOMER|PHOSPHO-NARP|PHOSPHO-NARX
NARQ-RXN.c	ADP|ATP|NARQ-MONOMER|PHOSPHO-NARQ
NARX-RXN.c	ADP|ATP|NARX-MONOMER|PHOSPHO-NARX
NICONUCADENYLYLTRAN-RXN.c	ATP|DEAMIDO-NAD|NICOTINATE_NUCLEOTIDE|PPI|PROTON
NICOTINAMID-RXN.c	AMMONIUM|NIACINAMIDE|NIACINE|WATER
NICOTINATEPRIBOSYLTRANS-RXN.p	ADP|ATP|NIACINE|NICOTINATE_NUCLEOTIDE|PPI|PRPP|Pi|WATER
NITRIC-OXIDE-REDUCTASE-RXN.c	Cytochromes-C-Oxidized|Cytochromes-C-Reduced|NITRIC-OXIDE|NITROUS-OXIDE|PROTON|WATER
NMNAMIDOHYDRO-RXN.c	AMMONIUM|NICOTINAMIDE_NUCLEOTIDE|NICOTINATE_NUCLEOTIDE|WATER
NMNNUCLEOSID-RXN.c	NIACINAMIDE|NICOTINAMIDE_NUCLEOTIDE|PROTON|RIBOSE-5P|WATER
NQOR-RXN.c	NAD-P-OR-NOP|NADH-P-OR-NOP|PROTON|Quinones|Reduced-Quinones
NRIDEPHOS-RXN.c	GLNG-CPLX|PROTEIN-NRIP|Pi|WATER
NRIIPHOS-RXN.c	ADP|ATP|PROTEIN-NRII|PROTEIN-NRIIP
NRIPHOS-RXN.c	GLNG-CPLX|PROTEIN-NRII|PROTEIN-NRIIP|PROTEIN-NRIP
NUCLEOSIDE-DIP-KIN-RXN.c	ADP|ATP|Nucleoside-Diphosphates|Nucleoside-Triphosphates
NUCLEOSIDE-DIPHOSPHATASE-RXN.c	Nucleoside-Diphosphates|Nucleoside-Monophosphates|PROTON|Pi|WATER
O-SUCCHOMOSERLYASE-RXN.c	CYS|L-CYSTATHIONINE|O-SUCCINYL-L-HOMOSERINE|PROTON|SUC
O-SUCCINYLBENZOATE-COA-LIG-RXN.c	AMP|ATP|CO-A|CPD-6972|O-SUCCINYLBENZOATE|PPI
O-SUCCINYLBENZOATE-COA-SYN-RXN.c	CPD-9923|O-SUCCINYLBENZOATE|WATER
OCTAPRENYL-METHYL-METHOXY-BENZOQ-OH-RXN.c	Acceptor|Donor-H2|OCTAPRENYL-METHYL-METHOXY-BENZQ|OCTAPRENYL-METHYL-OH-METHOXY-BENZQ|OXYGEN-MOLECULE|WATER
OHACYL-COA-DEHYDROG-RXN.c	3-KETOACYL-COA|L-3-HYDROXYACYL-COA|NAD|NADH|PROTON
OHBUTYRYL-COA-EPIM-RXN.c	D-3-HYDROXYACYL-COA|L-3-HYDROXYACYL-COA
OHMETHYLBILANESYN-RXN.c	AMMONIUM|HYDROXYMETHYLBILANE|PORPHOBILINOGEN|WATER
OHMETPYRKIN-RXN.c	ADP|AMINO-HYDROXYMETHYL-METHYL-PYR-P|ATP|HMP|PROTON
ORNCARBAMTRANSFER-RXN.c	CARBAMOYL-P|L-CITRULLINE|L-ORNITHINE|PROTON|Pi
ORNDECARBOX-RXN.c	CARBON-DIOXIDE|L-ORNITHINE|PROTON|PUTRESCINE
OROPRIBTRANS-RXN.c	OROTATE|OROTIDINE-5-PHOSPHATE|PPI|PRPP
OROTPDECARB-RXN.c	CARBON-DIOXIDE|OROTIDINE-5-PHOSPHATE|PROTON|UMP
OXALOACETATE-TAUTOMERASE-RXN.c	ENOL-OXALOACETATE|OXALACETIC_ACID
OXALODECARB-RXN.c	CARBON-DIOXIDE|OXALACETIC_ACID|PROTON|PYRUVATE
OXALYL-COA-DECARBOXYLASE-RXN.c	CARBON-DIOXIDE|FORMYL-COA|OXALYL-COA|PROTON
OXAMATE-CARBAMOYLTRANSFERASE-RXN.c	CARBAMOYL-P|CPD-389|OXAMATE|Pi
P-PANTOCYSDECARB-RXN.c	CARBON-DIOXIDE|PANTETHEINE-P|PROTON|R-4-PHOSPHOPANTOTHENOYL-L-CYSTEINE
P-PANTOCYSLIG-RXN.c	4-P-PANTOTHENATE|CMP|CTP|CYS|PPI|PROTON|R-4-PHOSPHOPANTOTHENOYL-L-CYSTEINE
PABASYN-RXN.c	4-AMINO-4-DEOXYCHORISMATE|CHORISMATE|GLN|GLT
PALMITOTRANS-RXN.p	ACP|KDO2-LIPID-IVA|KDO2-PALMITOLEOYL-LIPID-IVA|Palmitoleoyl-ACPs
PANTEPADENYLYLTRAN-RXN.c	ATP|DEPHOSPHO-COA|PANTETHEINE-P|PPI|PROTON
PANTOATE-BETA-ALANINE-LIG-RXN.c	AMP|ATP|B-ALANINE|L-PANTOATE|PANTOTHENATE|PPI|PROTON
PANTOTHENATE-KIN-RXN.c	4-P-PANTOTHENATE|ADP|ATP|PANTOTHENATE|PROTON
PDXJ-RXN.c	1-AMINO-PROPAN-2-ONE-3-PHOSPHATE|DEOXYXYLULOSE-5P|PROTON|PYRIDOXINE-5P|Pi|WATER
PEPCARBOX-RXN.c	HCO3|OXALACETIC_ACID|PHOSPHO-ENOL-PYRUVATE|Pi
PEPCARBOXYKIN-RXN.c	ADP|ATP|CARBON-DIOXIDE|OXALACETIC_ACID|PHOSPHO-ENOL-PYRUVATE
PEPDEPHOS-RXN.c	ADP|ATP|PHOSPHO-ENOL-PYRUVATE|PROTON|PYRUVATE
PEPSYNTH-RXN.c	AMP|ATP|PHOSPHO-ENOL-PYRUVATE|PROTON|PYRUVATE|Pi|WATER
PEPTIDYLPROLYL-ISOMERASE-RXN.c	CPD-8624|CPD-8625
PEPTIDYLPROLYL-ISOMERASE-RXN.e	CPD-8624|CPD-8625
PEPTIDYLPROLYL-ISOMERASE-RXN.p	CPD-8624|CPD-8625
PEROXID-RXN.p	HYDROGEN-PEROXIDE|Phenolic-Donors|Phenoxyl-rad-of-phenolic-donors|WATER
PFLDEACTIV-RXN.c	PYRUVFORMLY-CPLX|PYRUVFORMLY-INACTIVE-CPLX
PGLUCISOM-RXN.c	FRUCTOSE-6P|GLC-6-P
PGLUCONDEHYDRAT-RXN.c	2-KETO-3-DEOXY-6-P-GLUCONATE|CPD-2961|WATER
PGLYCDEHYDROG-RXN.c	3-P-HYDROXYPYRUVATE|G3P|NAD|NADH|PROTON
PGLYCEROLTRANSI-RXN.p	DIACYLGLYCEROL|L-1-PHOSPHATIDYL-GLYCEROL|MDO-6-Glycerophospho-D-Glucoses|MDO-D-Glucoses
PGLYCEROLTRANSII-RXN.p	MDO-6-Glycerophospho-D-Glucoses|MDO-D-Glucoses
PGPPHOSPHA-RXN.p	L-1-PHOSPHATIDYL-GLYCEROL|L-1-PHOSPHATIDYL-GLYCEROL-P|Pi|WATER
PHEAMINOTRANS-RXN.c	2-KETOGLUTARATE|GLT|PHE|PHENYL-PYRUVATE
PHENDEHYD-RXN.c	NAD|NADH|PHENYLACETALDEHYDE|PHENYLACETATE|PROTON|WATER
PHENPRODIOLDEHYDROG-RXN.c	2-3-DIHYDROXYPHENYL-PROPIONATE|CARBOXYETHYL-3-5-CYCLOHEXADIENE-1-2-DIOL|NAD|NADH|PROTON
PHENYLALANINE--TRNA-LIGASE-RXN.c	AMP|ATP|Charged-PHE-tRNAs|PHE|PHE-tRNAs|PPI|PROTON
PHENYLPYRUVATE-TAUTOMERASE-RXN.c	PHENYL-PYRUVATE
PHENYLSERINE-ALDOLASE-RXN.c	BENZALDEHYDE|CPD-644|GLY
PHOBCREC-RXN.c	CREC-CPLX|PHOB-MONOMER|PHOSPHO-CREC|PHOSPHO-PHOB
PHOBR-RXN.c	PHOB-MONOMER|PHOR-MONOMER|PHOSPHO-PHOB|PHOSPHO-PHOR
PHOP-RXN.c	PHOP-MONOMER|PHOQ-MONOMER|PHOSPHO-PHOP|PHOSPHO-PHOQ
PHOQ-RXN.c	ADP|ATP|PHOQ-MONOMER|PHOSPHO-PHOQ
PHOR-RXN.c	ADP|ATP|PHOR-MONOMER|PHOSPHO-PHOR
PHOSACETYLTRANS-RXN.c	ACETYL-COA|ACETYL-P|CO-A|Pi
PHOSGLYPHOS-RXN.c	ADP|ATP|DPG|G3P
PHOSICITDEHASE-RXN.c	ADP|ATP|Iso-Cit|isocitrate-dehydrogenase
PHOSMANMUT-RXN.c	MANNOSE-1P|MANNOSE-6P
PHOSNACMURPENTATRANS-RXN.p	C1|C5|CPD-9646|UMP
PHOSPHAGLYPSYN-RXN.p	CDPDIACYLGLYCEROL|CMP|GLYCEROL-3P|L-1-PHOSPHATIDYL-GLYCEROL-P|PROTON
PHOSPHASERDECARB-RXN.p	CARBON-DIOXIDE|L-1-PHOSPHATIDYL-ETHANOLAMINE|L-1-PHOSPHATIDYL-SERINE|PROTON
PHOSPHASERSYN-RXN.c	CDPDIACYLGLYCEROL|CMP|L-1-PHOSPHATIDYL-SERINE|PROTON|SER
PHOSPHOENOLPYRUVATE-PHOSPHATASE-RXN.p	PHOSPHO-ENOL-PYRUVATE|PYRUVATE|Pi|WATER
PHOSPHOGLUCMUT-RXN.c	ALPHA-GLC-6-P|GLC-1-P
PHOSPHOGLYCERATE-PHOSPHATASE-RXN.p	2-PG|GLYCERATE|Pi|WATER
PMPOXI-RXN.c	AMMONIUM|HYDROGEN-PEROXIDE|OXYGEN-MOLECULE|PYRIDOXAL_PHOSPHATE|PYRIDOXAMINE-5P|WATER
PNKIN-RXN.c	ADP|ATP|PROTON|PYRIDOXINE|PYRIDOXINE-5P
PNP-RXN.c	Pi|Purine-Bases|Purine-Ribonucleosides|RIBOSE-1P
PNPOXI-RXN.c	HYDROGEN-PEROXIDE|OXYGEN-MOLECULE|PYRIDOXAL_PHOSPHATE|PYRIDOXINE-5P
POLYNUCLEOTIDE-ADENYLYLTRANSFERASE-RXN.c	ATP|PPI|mRNAs
POLYNUCLEOTIDE-ADENYLYLTRANSFERASE-RXN.p	ATP|PPI|mRNAs
POLYPHOSPHATE-KINASE-RXN.c	ADP|ATP|Long-Chain-Polyphosphate
PORPHOBILSYNTH-RXN.c	5-AMINO-LEVULINATE|PORPHOBILINOGEN|PROTON|WATER
PPENTOMUT-RXN.c	RIBOSE-1P|RIBOSE-5P
PPGPPSYN-RXN.c	GDP|GUANOSINE-5DP-3DP|PPI|PROTON|WATER
PPPGPPHYDRO-RXN.c	GDP-TP|GUANOSINE-5DP-3DP|PROTON|Pi|WATER
PRAISOM-RXN.c	CARBOXYPHENYLAMINO-DEOXYRIBULOSE-P|N-5-PHOSPHORIBOSYL-ANTHRANILATE
PREPHENATEDEHYDRAT-RXN.c	CARBON-DIOXIDE|PHENYL-PYRUVATE|PREPHENATE|PROTON|WATER
PREPHENATEDEHYDROG-RXN.c	CARBON-DIOXIDE|NAD|NADH|P-HYDROXY-PHENYLPYRUVATE|PREPHENATE
PRIBFAICARPISOM-RXN.c	PHOSPHORIBOSYL-FORMIMINO-AICAR-P|PHOSPHORIBULOSYL-FORMIMINO-AICAR-P
PRODISULFREDUCT-A-RXN.c	GLUTATHIONE|OXIDIZED-GLUTATHIONE|Ox-Glutaredoxins|Red-Glutaredoxins
PROLINE--TRNA-LIGASE-RXN.c	AMP|ATP|Charged-PRO-tRNAs|PPI|PRO|PRO-tRNAs|PROTON
PROLINE-MULTI.c	ADP|ATP|GLT|L-GLUTAMATE_GAMMA-SEMIALDEHYDE|NADP|NADPH|PROTON|Pi
PROPIONATE--COA-LIGASE-RXN.c	AMP|ATP|CO-A|PPI|PROPIONATE|PROPIONYL-COA
PROPIONYL-COA-CARBOXY-RXN.c	ADP|ATP|D-METHYL-MALONYL-COA|HCO3|PROPIONYL-COA|PROTON|Pi
PROPKIN-RXN.c	ADP|ATP|PROPIONATE|PROPIONYL-P
PROPKIN-RXN.e	ADP|ATP|PROPIONATE|PROPIONYL-P
PROTEIN-KINASE-RXN.c	ADP|ATP|PROTON
PROTEIN-TYROSINE-PHOSPHATASE-RXN.c	Pi|Protein-Tyrosines|Protein-tyrosine-phosphates|WATER
PROTOHEMEFERROCHELAT-RXN.c	FE+2|PROTOHEME|PROTON|PROTOPORPHYRIN_IX
PROTOPORGENOXI-RXN.c	HYDROGEN-PEROXIDE|OXYGEN-MOLECULE|PROTOPORPHYRINOGEN|PROTOPORPHYRIN_IX
PRPPAMIDOTRANS-RXN.c	5-P-BETA-D-RIBOSYL-AMINE|GLN|GLT|PPI|PRPP|WATER
PRPPSYN-RXN.c	AMP|ATP|PROTON|PRPP|RIBOSE-5P
PRTRANS-RXN.c	ANTHRANILATE|N-5-PHOSPHORIBOSYL-ANTHRANILATE|PPI|PRPP
PSERTRANSAM-RXN.c	2-KETOGLUTARATE|3-P-HYDROXYPYRUVATE|3-P-SERINE|GLT
PSERTRANSAMPYR-RXN.c	2-KETOGLUTARATE|3OH-4P-OH-ALPHA-KETOBUTYRATE|4-PHOSPHONOOXY-THREONINE|GLT
PSEUDOURIDINE-KINASE-RXN.c	ADP|ATP|CPD-497|PROTON|PSEUDOURIDINE-5-P
PTAALT-RXN.c	CO-A|PROPIONYL-COA|PROPIONYL-P|Pi
PUTTRANSAM-RXN.c	2-KETOGLUTARATE|4-AMINO-BUTYRALDEHYDE|GLT|PUTRESCINE
PYRAMKIN-RXN.c	ADP|ATP|PROTON|PYRIDOXAMINE|PYRIDOXAMINE-5P
PYRAZIN-RXN.c	AMMONIUM|PYRAZINAMIDE|PYRAZINOIC-ACID|WATER
PYRIDOXKIN-RXN.c	ADP|ATP|PROTON|PYRIDOXAL|PYRIDOXAL_PHOSPHATE
PYRIMSYN1-RXN.c	5-PHOSPHORIBOSYL-5-AMINOIMIDAZOLE|AMINO-HYDROXYMETHYL-METHYL-PYR-P|CARBON-MONOXIDE|CH33ADO|FORMATE|MET|PROTON|S-ADENOSYLMETHIONINE
PYRIMSYN3-RXN.c	ADP|AMINO-HYDROXYMETHYL-METHYL-PYR-P|AMINO-HYDROXYMETHYL-METHYLPYRIMIDINE-PP|ATP
PYRNUTRANSHYDROGEN-RXN.c	NAD|NADH|NADP|NADPH
PYROXALTRANSAM-RXN.c	L-ASPARTATE|OXALACETIC_ACID|PYRIDOXAL|PYRIDOXAMINE
PYRROLINECARBDEHYDROG-RXN.c	GLT|L-DELTA1-PYRROLINE_5-CARBOXYLATE|NAD|NADH|PROTON|WATER
PYRROLINECARBREDUCT-RXN.c	L-DELTA1-PYRROLINE_5-CARBOXYLATE|NAD-P-OR-NOP|NADH-P-OR-NOP|PRO|PROTON
PYRUFLAVREDUCT-RXN.c	ACETYL-COA|CARBON-DIOXIDE|CO-A|Oxidized-ferredoxins|PROTON|PYRUVATE|Reduced-ferredoxins
PYRUVATEDECARB-RXN.c	CARBON-DIOXIDE|LIPOAMIDE|PROTON|PYRUVATE|S-ACETYLDIHYDROLIPOAMIDE
PYRUVDEH-RXN.c	ACETYL-COA|CARBON-DIOXIDE|CO-A|NAD|NADH|PYRUVATE
PYRUVFORMLY-RXN.c	ACETYL-COA|CO-A|FORMATE|PYRUVATE
QOR-RXN.c	NADP|NADPH|Quinones|Semiquinones
QUERCETIN-23-DIOXYGENASE-RXN.c	2-PROTOCATECHUOYLPHLOROGLUCINOLCARBOXYLA|CARBON-MONOXIDE|CPD-520|OXYGEN-MOLECULE
QUINOLINATE-SYNTHA-RXN.c	DIHYDROXY-ACETONE-PHOSPHATE|IMINOASPARTATE|Pi|QUINOLINATE|WATER
QUINOPRIBOTRANS-RXN.c	CARBON-DIOXIDE|NICOTINATE_NUCLEOTIDE|PPI|PROTON|PRPP|QUINOLINATE
R131-RXN.c	BIO-5-AMP|BIOTINLIG-MONOMER|MONOMER-48
R134-RXN.c	ACYL-COA|MONOMER-51|PD01520
R136-RXN.c	CPLX-127|FRU1P|PC00061
R137-RXN.c	CPLX-128|FRUCTOSE-16-DIPHOSPHATE|PC00061
R138-RXN.c	GALACTOSE|MONOMER-52|PD03028
R139-RXN.c	GALACTOSE|MONOMER-53|PD00261
R140-RXN.c	GLYCEROL-3P|MONOMER-54|PD03576
R143-RXN.c	GLUCONATE|MONOMER-55|PD03585
R148-RXN.c	MONOMER-60|PD03867|RIBOSE
R15-RXN.c	2-Oxo-carboxylates|Amino-Acids-20|CPD-479|MET
R165-RXN.c	CPD-1091|CPD-389|NAD-P-OR-NOP|NADH-P-OR-NOP|PROTON
R166-RXN.c	ATP|MALTOTRIOSE|MONOMER0-158|PD00237
R167-RXN.c	ALLOLACTOSE|MONOMER0-159|PD00763
R170-RXN.p	CU+|CU+2|NAD|NADH|PROTON
R185-RXN.c	MONOMER0-163|PD00413|PHE
R247-RXN.c	Cytochromes-C-Oxidized|Cytochromes-C-Reduced|NITRATE|NITRITE|WATER
R303-RXN.c	NADP|NADPH|Nitroaromatic-Ox-Compounds|Nitroaromatic-Red-Compounds
R4-RXN.c	Alcohols|Alkyl-Hydro-Peroxides|NAD|NADH|PROTON|WATER
R524-RXN.c	CARBAMATE|CARBON-DIOXIDE|CPD-69|HCO3|PROTON
R601-RXN.p	FUM|Menaquinols|Menaquinones|SUC
R621-RXN.c	NAD-P-OR-NOP|NADH-P-OR-NOP|NITRATE|NITRIC-OXIDE|OXYGEN-MOLECULE|PROTON
RCSC-RXN.c	ADP|ATP|PHOSPHO-RCSC|RCSC-MONOMER
REDUCEDFE-S-RXN.c	E-|FeS-Proteins|FeS-Proteins-Reduced
RFFTRANS-RXN.c	2-KETOGLUTARATE|DTDP-DEOH-DEOXY-GLUCOSE|GLT|TDP-D-FUCOSAMINE
RHAMNISOM-RXN.c	RHAMNULOSE
RHAMNULOKIN-RXN.c	ADP|ATP|PROTON|RHAMNULOSE|RHAMNULOSE-1P
RHAMNULPALDOL-RXN.c	DIHYDROXY-ACETONE-PHOSPHATE|LACTALD|RHAMNULOSE-1P
RIB5PISOM-RXN.c	RIBOSE-5P|RIBULOSE-5P
RIBAZOLEPHOSPHAT-RXN.c	ALPHA-RIBAZOLE|ALPHA-RIBAZOLE-5-P|Pi|WATER
RIBOFLAVIN-SYN-RXN.c	AMINO-RIBOSYLAMINO-1H-3H-PYR-DIONE|DIMETHYL-D-RIBITYL-LUMAZINE|PROTON|RIBOFLAVIN
RIBOFLAVINKIN-RXN.c	ADP|ATP|FMN|PROTON|RIBOFLAVIN
RIBOFLAVINSYNDEAM-RXN.c	AMMONIUM|CPD-602|DIAMINO-OH-PHOSPHORIBOSYLAMINO-PYR|PROTON|WATER
RIBOFLAVINSYNREDUC-RXN.c	CPD-1086|CPD-602|NADP|NADPH|PROTON
RIBOKIN-RXN.c	ADP|ATP|PROTON|RIBOSE-5P
RIBONUCLEOSIDE-DIP-REDUCTI-RXN.c	Deoxy-Ribonucleoside-Diphosphates|Ox-Thioredoxin|Red-Thioredoxin|Ribonucleoside-Diphosphates|WATER
RIBONUCLEOSIDE-DIP-REDUCTII-RXN.c	CDP|DCDP|Oxidized-NrdH-Proteins|Reduced-NrdH-Proteins|WATER
RIBONUCLEOSIDE-TRIP-REDUCT-RXN.c	Deoxy-Ribonucleoside-Triphosphates|Oxidized-flavodoxins|Reduced-flavodoxins|Ribonucleoside-Triphosphates|WATER
RIBOPHOSPHAT-RXN.c	AMINO-RIBOSYLAMINO-1H-3H-PYR-DIONE|CPD-1086|Pi|WATER
RIBOSYLHOMOCYSTEINASE-RXN.c	CPD-564|DIHYDROXYPENTANEDIONE|HOMO-CYS
RIBOSYLNICOTINAMIDE-KINASE-RXN.c	ADP|ATP|NICOTINAMIDE_NUCLEOTIDE|NICOTINAMIDE_RIBOSE|PROTON
RIBOSYLPYRIMIDINE-NUCLEOSIDASE-RXN.c	PROTON|Pyrimidine-Bases|Pyrimidine-Nucleosides|WATER
RIBULP3EPIM-RXN.c	RIBULOSE-5P|XYLULOSE-5-PHOSPHATE
RIBULPEPIM-RXN.c	L-RIBULOSE-5-P|XYLULOSE-5-PHOSPHATE
RNA-3-PHOSPHATE-CYCLASE-RXN.c	3-Prime-Phosphate-Terminated-RNAs|AMP|ATP|Cyclic-Phosphate-Terminated-RNAs|PPI
RNTRACTIV-RXN.c	CH33ADO|MET|Ribonuc-tri-P-reductases-active|Ribonuc-tri-P-reductases-inactive|S-ADENOSYLMETHIONINE
RSTA-RXN.ce	PHOSPHO-RSTA|PHOSPHO-RSTB|RSTA-MONOMER|RSTB-MONOMER
RSTB-RXN.ce	ADP|ATP|PHOSPHO-RSTB|RSTB-MONOMER
RXN-10015.c	CPD-10773|DIHYDROXYPENTANEDIONE
RXN-10016.c	CPD-10775|DIHYDROXYPENTANEDIONE
RXN-10017.c	CPD-10773|CPD-10774|WATER
RXN-10018.c	CPD-10775|CPD-10776|WATER
RXN-10040.c	CPD-10796|CPD-10797|NAD|NADH|OXYGEN-MOLECULE|PROTON|WATER
RXN-10462.p	ACP|ACYL-ACP|ACYL-SN-GLYCEROL-3P|GLYCEROL-3P
RXN-10639.c	CPD-448|GLC-1-P
RXN-10654.c	3-oxo-cis-D7-tetradecenoyl-ACPs|ACP|CARBON-DIOXIDE|Cis-Delta5-dodecenoyl-ACPs|MALONYL-ACP|PROTON
RXN-10655.c	3-hydroxy-cis-D7-tetraecenoyl-ACPs|3-oxo-cis-D7-tetradecenoyl-ACPs|NADP|NADPH|PROTON
RXN-10656.c	3-hydroxy-cis-D7-tetraecenoyl-ACPs|Trans-D3-cis-D7-tetradecenoyl-ACPs|WATER
RXN-10657.c	Cis-Delta7-tetradecenoyl-ACPs|NAD|NADH|PROTON|Trans-D3-cis-D7-tetradecenoyl-ACPs
RXN-10658.c	3-oxo-cis-D9-hexadecenoyl-ACPs|ACP|CARBON-DIOXIDE|Cis-Delta7-tetradecenoyl-ACPs|MALONYL-ACP|PROTON
RXN-10659.c	3-hydroxy-cis-D9-hexaecenoyl-ACPs|3-oxo-cis-D9-hexadecenoyl-ACPs|NADP|NADPH|PROTON
RXN-10660.c	3-hydroxy-cis-D9-hexaecenoyl-ACPs|Trans-D3-cis-D9-hexadecenoyl-ACPs|WATER
RXN-10661.c	NAD|NADH|PROTON|Palmitoleoyl-ACPs|Trans-D3-cis-D9-hexadecenoyl-ACPs
RXN-10720.c	CPD-476|KYNURENATE|PROTON|WATER
RXN-10819.c	AMP|ATP|CO-A|CPD-207|PHENYLACETATE|PPI
RXN-10856.c	CPD-11770|DIHYDRO-NEO-PTERIN
RXN-10940.p	MI-HEXAKISPHOSPHATE|MI-PENTAKISPHOSPHATE|Pi|WATER
RXN-10981.c	ASCORBATE|Acceptor|CPD-318|Donor-H2|PROTON
RXN-11109.c	ADP|ATP|PROTON|Pi|WATER
RXN-11193.p	2-Oxo-carboxylates|AMMONIUM|D-Amino-Acids|ETR-Quinols|ETR-Quinones|WATER
RXN-11302.p	CPD-12231|CPD-12261|D-ALANINE
RXN-11313.c	ACET|CHITOBIOSE|WATER
RXN-11319.c	Acceptor|CH33ADO|CPD-108|CPD-12279|Donor-H2|MET|PROTON|S-ADENOSYLMETHIONINE|TYR
RXN-11361.c	ATP|Carboxyadenylated-MPT-synthases|MPT-Synthases|PPI
RXN-11396.c	CPD-12365|CPD0-1905|PPI|PROTON|WATER
RXN-11397.c	CPD-12366|PPI|PROTON|WATER
RXN-11409.c	CPD-12366|CPD-12377|GTP|PROTON
RXN-11410.c	CPD-12377|CPD0-1905|DGTP|PROTON
RXN-11474.c	3-Ketoglutaryl-ACP-methyl-ester|ACP|CARBON-DIOXIDE|MALONYL-ACP|PROTON
RXN-11475.c	ADENOSYL-HOMO-CYS|MALONYL-ACP|S-ADENOSYLMETHIONINE
RXN-11476.c	3-Hydroxyglutaryl-ACP-methyl-ester|3-Ketoglutaryl-ACP-methyl-ester|NADP|NADPH|PROTON
RXN-11477.c	3-Hydroxyglutaryl-ACP-methyl-ester|Enoylglutaryl-ACP-methyl-esters|WATER
RXN-11478.c	Enoylglutaryl-ACP-methyl-esters|Glutaryl-ACP-methyl-esters|NAD|NADH|PROTON
RXN-11479.c	3-Ketopimeloyl-ACP-methyl-esters|ACP|CARBON-DIOXIDE|Glutaryl-ACP-methyl-esters|MALONYL-ACP|PROTON
RXN-11480.c	3-Ketopimeloyl-ACP-methyl-esters|3-hydroxypimeloyl-ACP-methyl-esters|NADP|NADPH|PROTON
RXN-11481.c	3-hydroxypimeloyl-ACP-methyl-esters|Enoylpimeloyl-ACP-methyl-esters|WATER
RXN-11482.c	Enoylpimeloyl-ACP-methyl-esters|NAD|NADH|PROTON|Pimeloyl-ACP-methyl-esters
RXN-11483.c	METOH|PROTON|Pimeloyl-ACP-methyl-esters|Pimeloyl-ACPs|WATER
RXN-11484.c	8-AMINO-7-OXONONANOATE|ACP|CARBON-DIOXIDE|L-ALPHA-ALANINE|PROTON|Pimeloyl-ACPs
RXN-11496.p	ACET|CARBON-DIOXIDE|PYRUVATE|Ubiquinols|Ubiquinones|WATER
RXN-11573.c	23S-rRNA-N1-methylguanine745|23S-rRNA-guanine-745|ADENOSYL-HOMO-CYS|PROTON|S-ADENOSYLMETHIONINE
RXN-11574.c	23S-RRNA-N2-METHYLGUANINE2445|23S-rRNA-guanine-2445|ADENOSYL-HOMO-CYS|PROTON|S-ADENOSYLMETHIONINE
RXN-11576.c	16S-rRNA-N2-methylguanine1207|16S-rRNA-guanine-1207|ADENOSYL-HOMO-CYS|PROTON|S-ADENOSYLMETHIONINE
RXN-11578.c	16S-rRNA-N7-methylguanine527|16S-rRNA-guanine-527|ADENOSYL-HOMO-CYS|S-ADENOSYLMETHIONINE
RXN-11586.c	23S-rRNA-2-methyladenine2503|23S-rRNA-adenine-2503|ADENOSYL-HOMO-CYS|CH33ADO|MET|S-ADENOSYLMETHIONINE
RXN-11588.c	23S-rRNA-2-O-methylguanosine2251|23S-rRNA-guanine-2551|ADENOSYL-HOMO-CYS|PROTON|S-ADENOSYLMETHIONINE
RXN-11589.c	23S-rRNA-2-O-methylcytidine2498|23S-rRNA-cytidine-2498|ADENOSYL-HOMO-CYS|PROTON|S-ADENOSYLMETHIONINE
RXN-11591.c	16S-rRNA-5-O-methylcytosine967|16S-rRNA-cytosine967|ADENOSYL-HOMO-CYS|PROTON|S-ADENOSYLMETHIONINE
RXN-11592.c	23S-rRNA-N3-methylpseudouridine1915|23S-rRNA-pseudouridine1915|ADENOSYL-HOMO-CYS|PROTON|S-ADENOSYLMETHIONINE
RXN-11593.c	16S-rRNA-5-O-methylcytosine1407|16S-rRNA-cytosine1407|ADENOSYL-HOMO-CYS|PROTON|S-ADENOSYLMETHIONINE
RXN-11596.c	23S-rRNA-adenine-1618|ADENOSYL-HOMO-CYS|PROTON|S-ADENOSYLMETHIONINE
RXN-11598.c	16S-rRNA-N3-methyluracil1498|16S-rRNA-uracil1498|ADENOSYL-HOMO-CYS|PROTON|S-ADENOSYLMETHIONINE
RXN-11600.c	23S-rRNA-5-methyluracil747|23S-rRNA-uracil-747|ADENOSYL-HOMO-CYS|PROTON|S-ADENOSYLMETHIONINE
RXN-11601.c	23S-rRNA-5-methyluracil1939|23S-rRNA-uracil-1939|ADENOSYL-HOMO-CYS|PROTON|S-ADENOSYLMETHIONINE
RXN-11602.c	23S-rRNA-5-methylcytosine1962|23S-rRNA-cytosine-1962|ADENOSYL-HOMO-CYS|PROTON|S-ADENOSYLMETHIONINE
RXN-11633.c	16S-rRNA-N6-dimethyladenine1518-1519|16S-rRNA-adenine1518-adenine1519|ADENOSYL-HOMO-CYS|PROTON|S-ADENOSYLMETHIONINE
RXN-11635.c	23S-rRNA-N2-methylguanine1835|23S-rRNA-guanine-1835|ADENOSYL-HOMO-CYS|PROTON|S-ADENOSYLMETHIONINE
RXN-11637.c	16S-rRNA-2-O-methylcytidine1402|16S-rRNA-cytidine1402|ADENOSYL-HOMO-CYS|PROTON|S-ADENOSYLMETHIONINE
RXN-11638.c	16S-rRNA-N4-methylcytidine1402|16S-rRNA-cytidine1402|ADENOSYL-HOMO-CYS|PROTON|S-ADENOSYLMETHIONINE
RXN-11811.c	AMMONIA|AMMONIUM|PROTON
RXN-11832.c	ADP|ATP|CDP|CMP
RXN-11833.c	16S-rRNA-pseudouridine516|16S-rRNA-uridine516
RXN-11834.c	23S-rRNA-pseudouridine2457|23S-rRNA-uridine2457
RXN-11835.c	23S-rRNA-pseudouridine2604|23S-rRNA-uridine2604
RXN-11836.c	23S-rRNA-pseudouridine2605|23S-rRNA-uridine2605
RXN-11837.c	23S-rRNA-pseudouridine1911-1915-1917|23S-rRNA-uridine1911-1915-1917
RXN-11838.c	23S-rRNA-pseudouridine955-2504-2580|23S-rRNA-uridine955-2504-2580
RXN-11839.c	tRNA-pseudouridine55|tRNA-uridine55
RXN-11840.c	tRNA-pseudouridine65|tRNA-uridine65
RXN-11841.c	tRNA-pseudouridine13|tRNA-uridine13
RXN-11842.c	tRNA-pseudouridine32|tRNA-uridine32
RXN-11843.c	23S-rRNA-pseudouridine746|23S-rRNA-uridine746
RXN-11845.c	23S-rRNA-2-O-methyluridine2552|23S-rRNA-uridine-2552|ADENOSYL-HOMO-CYS|PROTON|S-ADENOSYLMETHIONINE
RXN-11860.c	2-O-Methylcytidine-34-tRNAs|ADENOSYL-HOMO-CYS|Cytidine-34-tRNAs|PROTON|S-ADENOSYLMETHIONINE
RXN-11865.c	5-CarboxyMeAmMe-2-O-MeU34-tRNALeu|5-carbo-me-ami-me-ur-34-tRNALeu|ADENOSYL-HOMO-CYS|PROTON|S-ADENOSYLMETHIONINE
RXN-11866.c	2-O-Methylcytidine-32-tRNAs|ADENOSYL-HOMO-CYS|Cytidine-32-tRNAs|PROTON|S-ADENOSYLMETHIONINE
RXN-11867.c	2-O-Methyluridine32-tRNA|ADENOSYL-HOMO-CYS|PROTON|S-ADENOSYLMETHIONINE|Uridine32-in-tRNA
RXN-12002.c	ADP|ATP|UDP|UMP
RXN-12070.c	CPD0-2184|FUM|PROTON|WATER
RXN-12071.c	CPD-10796|CPD-13034|NAD|NADH|PROTON
RXN-12072.c	CPD-13034|CPD-674|NAD|NADH|OXYGEN-MOLECULE|PROTON
RXN-12073.c	CPD-10796|CPD0-2184|OXYGEN-MOLECULE|PROTON
RXN-12093.c	7-CYANO-7-DEAZAGUANINE|ADP|AMMONIUM|ATP|CPD-13043|PROTON|Pi|WATER
RXN-12104.c	tRNAs-containing-epoxy-quenosine
RXN-12105.c	25-DIDEHYDRO-D-GLUCONATE|CPD-13059|NAD-P-OR-NOP|NADH-P-OR-NOP|PROTON
RXN-12149.c	L-RHAMNOFURANOSE
RXN-12195.c	CDP|CTP|PROTON|Pi|WATER
RXN-12197.c	PROTON|Pi|UDP|UMP|WATER
RXN-12198.c	CDP|CMP|PROTON|Pi|WATER
RXN-12274.c	CARBON-DIOXIDE|FORMATE|Oxidized-hydrogenase-3|PROTON|Reduced-hydrogenase-3
RXN-12274.e	CARBON-DIOXIDE|FORMATE|Oxidized-hydrogenase-3|PROTON|Reduced-hydrogenase-3
RXN-12275.p	HYDROGEN-MOLECULE|Oxidized-hydrogenase-3|PROTON|Reduced-hydrogenase-3
RXN-12352.p	OXYGEN-MOLECULE|Ubiquinols|Ubiquinones|WATER
RXN-12353.c	2-KETOGLUTARATE|CARBON-DIOXIDE|FORMALDEHYDE|Methylated-DNA-Bases|Nucleobases-in-DNA|OXYGEN-MOLECULE|PROTON|SUC
RXN-12402.c	CPD0-1202|GLC|WATER|XYLOSE
RXN-12440.c	ASCORBATE|HYDROGEN-PEROXIDE|L-DEHYDRO-ASCORBATE|PROTON|WATER
RXN-12444.c	FMN|FMNH2|NADP|NADPH|PROTON
RXN-12445.c	CPD-316|NAD-P-OR-NOP|NADH-P-OR-NOP|PROTON|RIBOFLAVIN
RXN-12458.c	ADENOSYL-HOMO-CYS|Guanine37-in-tRNA|PROTON|S-ADENOSYLMETHIONINE|tRNA-Containing-N1-Methylguanine-37
RXN-12473.p	AMP|Carboxyadenylated-MPT-synthases|L-Cysteine-Desulfurases|Persulfurated-L-cysteine-desulfurases|Thiocarboxylated-MPT-synthases
RXN-12480.c	ADENOSYL-HOMO-CYS|PROTON|S-ADENOSYLMETHIONINE|Val-tRNA1-Adenine37|Val-tRNA1-N6-MeAdenine37
RXN-12508.c	2-ALPHA-HYDROXYETHYL-THPP|PROTON|Pyruvate-dehydrogenase-acetylDHlipoyl|Pyruvate-dehydrogenase-lipoate|THIAMINE-PYROPHOSPHATE
RXN-12539.c	CARBON-DIOXIDE|CPD-12377|CPD-479|CPD-7671|ETHYLENE-CMPD
RXN-12540.c	CPD-12377|FE+2|FE+3|HYDROGEN-PEROXIDE|OH
RXN-12541.c	FE+2|FE+3|OXYGEN-MOLECULE|SUPER-OXIDE
RXN-12583.c	2-ALPHA-HYDROXYETHYL-THPP|CARBON-DIOXIDE|PROTON|PYRUVATE|THIAMINE-PYROPHOSPHATE
RXN-12587.c	L-Cysteine-Desulfurases|Persulfurated-L-cysteine-desulfurases|Sulfurated-Sulfur-Acceptors|Unsulfurated-Sulfur-Acceptors
RXN-12588.c	CYS|L-ALPHA-ALANINE|PROTON|Sulfurated-Sulfur-Acceptors|Unsulfurated-Sulfur-Acceptors
RXN-12611.c	AMINO-HYDROXYMETHYL-METHYLPYRIMIDINE-PP|CARBON-DIOXIDE|CPD-13575|PPI|PROTON|THIAMINE-P
RXN-12618.p	CYS-GLY|GLT|GLUTATHIONE|WATER
RXN-12752.c	CPD-653|CPD0-2472
RXN-12753.c	CPD-653|NADH|WATER
RXN-12754.c	CPD0-2472|NADH|WATER
RXN-12816.c	CPD-12365|PROTON|Pi|WATER
RXN-12827.c	E-|NITRATE|NITRITE|PROTON|WATER
RXN-12861.c	CPD-13907|CPD-334|PROTON
RXN-12862.c	CPD-13907|L-DEHYDRO-ASCORBATE|WATER
RXN-12864.c	CPD-13908|GLUTATHIONE|OXIDIZED-GLUTATHIONE|PROTON|SELENITE|WATER
RXN-12869.c	CPD-13914|L-DEHYDRO-ASCORBATE|OXYGEN-MOLECULE|PROTON
RXN-12870.c	CPD-13913|CPD-334
RXN-12871.c	CPD-13912|CPD-13913|PROTON|WATER
RXN-12872.c	CPD-13910|CPD-13914
RXN-12876.c	ASCORBATE|Cytochromes-C-Oxidized|Cytochromes-C-Reduced|L-DEHYDRO-ASCORBATE|PROTON
RXN-12886.c	CPD-13927|FMN|FMNH2|OXYGEN-MOLECULE|PROTON|THYMINE
RXN-12896.c	CARBAMATE|CPD-13927|CPD-13930|PROTON|WATER
RXN-13039.c	AMP|LIPOYL-AMP|PROTEIN-LIPOYLLYSINE|PROTON
RXN-13141.c	ADP|AMP|CPD0-2474|NADPH|PROTON|Pi
RXN-13142.c	CPD-14133|CPD0-2474
RXN-13202.c	ADP|AMMONIUM|ATP|CARBAMOYL-P|HCO3|PROTON|Pi
RXN-13248.c	CARBON-DIOXIDE|PROTON
RXN-13329.c	AMMONIUM|CPD-12279|GLYOX|PROTON|WATER
RXN-13418.c	CPD-3745|FMN|FMNH2|GLYCOLALDEHYDE|OXYGEN-MOLECULE|PROTON|SO3|WATER
RXN-13459.c	OXOPENTENOATE
RXN-13460.c	4-HYDROXY-2-KETOVALERATE
RXN-13463.c	OXOPENTENOATE
RXN-13519.ce	PROTON
RXN-1381.p	ACYL-SN-GLYCEROL-3P|CO-A|GLYCEROL-3P
RXN-13853.c	NAD-P-OR-NOP|NADH-P-OR-NOP|Nitroaromatic-Ox-Compounds|Nitroaromatic-Red-Compounds
RXN-13854.c	AMMONIUM|NAD|NADH|NITRITE|PROTON|WATER
RXN-13872.c	NAD|NIACINAMIDE
RXN-13873.c	ADENOSINE_DIPHOSPHATE_RIBOSE|PROTON|WATER
RXN-13990.c	GLYOX|PYRUVATE
RXN-14002.c	PROTON|Pi|WATER
RXN-14014.c	DELTA1-PIPERIDEINE-2-6-DICARBOXYLATE|NADP|NADPH|PROTON|WATER
RXN-14025.c	Pi|UMP|URIDINE|WATER
RXN-14026.c	CMP|CYTIDINE|Pi|WATER
RXN-14064.p	CPD-3708|CPD-3709|PROTON|WATER
RXN-14073.c	GLYCEROL|GLYCEROL-3P|GLYCEROPHOSPHOGLYCEROL|PROTON|WATER
RXN-14074.c	ADP|AMP|GDP|GTP
RXN-14090.c	CPD-3711|CYTIDINE|Pi|WATER
RXN-14090.p	CPD-3711|CYTIDINE|Pi|WATER
RXN-14091.p	CPD-3724|CPD-3725|PROTON|WATER
RXN-14112.p	CPD-3711|CPD-3713|PROTON|WATER
RXN-14113.p	CPD-3706|CPD-3707|PROTON|WATER
RXN-14115.p	CPD-3724|Pi|URIDINE|WATER
RXN-14116.c	GLT|L-GLUTAMATE_GAMMA-SEMIALDEHYDE|NAD|NADH|PROTON|WATER
RXN-14124.p	CPD-3708|GUANOSINE|Pi|WATER
RXN-14126.c	ADENOSINE|CPD-3706|Pi|WATER
RXN-14126.p	ADENOSINE|CPD-3706|Pi|WATER
RXN-14136.c	CPD0-2030|GLYCEROL-3P|PROTON|SER|WATER
RXN-14139.c	PPI|PROTON|UMP|UTP|WATER
RXN-14142.c	DEOXYGUANOSINE|DGMP|Pi|WATER
RXN-14143.c	DEOXYURIDINE|DUMP|Pi|WATER
RXN-14160.c	ETHANOL-AMINE|GLYCEROL-3P|L-1-GLYCEROPHOSPHORYLETHANOL-AMINE|PROTON|WATER
RXN-14161.c	DAMP|DEOXYADENOSINE|Pi|WATER
RXN-14181.p	PYRIDOXINE|PYRIDOXINE-5P|Pi|WATER
RXN-14188.c	5-HYDROXY-CTP|PPI|PROTON|WATER
RXN-14260.c	MALTOPENTAOSE|MALTOSE|MALTOTETRAOSE
RXN-14261.c	GLC|MALTOHEXAOSE|MALTOPENTAOSE|MALTOSE
RXN-14281.c	ALPHA-GLUCOSE|MALTOPENTAOSE|MALTOTETRAOSE|WATER
RXN-14282.c	ALPHA-GLUCOSE|MALTOHEXAOSE|MALTOPENTAOSE|WATER
RXN-14283.c	ALPHA-GLUCOSE|CPD0-1133|MALTOHEXAOSE|WATER
RXN-14284.c	GLC-1-P|MALTOPENTAOSE|MALTOTETRAOSE|Pi
RXN-14285.c	GLC-1-P|MALTOHEXAOSE|MALTOPENTAOSE|Pi
RXN-14286.c	CPD0-1133|GLC-1-P|MALTOHEXAOSE|Pi
RXN-14290.c	CPD-12377|DATP|PROTON
RXN-14325.c	ADP|AMMONIUM|ATP|CTP|PROTON|Pi|UTP
RXN-14361.e	CPD0-934|UDP|UDP-GLUCURONATE
RXN-14363.p	CPD0-939|DIACYLGLYCEROL|L-1-PHOSPHATIDYL-ETHANOLAMINE
RXN-14379.p	CPD0-939|DIACYLGLYCEROL|L-1-PHOSPHATIDYL-ETHANOLAMINE
RXN-14382.c	L-Cysteine-Desulfurases|Persulfurated-L-cysteine-desulfurases|Sulfur-Carrier-Proteins-ThiI
RXN-14393.c	CPD0-1163|NAD|NADH|PROTON
RXN-14394.c	ACETYL-COA|CO-A
RXN-14396.c	HYDROXYMETHYLBILANE|WATER
RXN-14473.p	Nucleoside-Monophosphates|Nucleosides|Pi|WATER
RXN-14477.c	CPD0-2483|ENTEROBACTIN|PROTON|WATER
RXN-14478.c	CPD0-2483|N-23-DIHYDROXYBENZOYL-L-SERINE|PROTON|WATER
RXN-14479.c	N-23-DIHYDROXYBENZOYL-L-SERINE|PROTON|WATER
RXN-14480.c	CH33ADO|MET|S-ADENOSYLMETHIONINE|Sulfurated-Sulfur-Acceptors|Unsulfurated-Sulfur-Acceptors
RXN-14481.c	ADENOSYL-HOMO-CYS|PROTON|S-ADENOSYLMETHIONINE
RXN-14483.c	Pi|WATER
RXN-14497.c	CPD0-1564|D-CYSTEINE|GLUTATHIONE|OXIDIZED-GLUTATHIONE
RXN-14498.c	CYS|CYSTINE|Ox-Thioredoxin|Red-Thioredoxin
RXN-14499.c	CPD0-1564|D-CYSTEINE|Ox-Thioredoxin|Red-Thioredoxin
RXN-14505.p	L-THREONINE-O-3-PHOSPHATE|Pi|THR|WATER
RXN-14509.p	Pi|RIBOSE-5P|WATER
RXN-14510.p	CPD-3723|Pi|URIDINE|WATER
RXN-14511.p	CPD-3710|CYTIDINE|Pi|WATER
RXN-14512.p	CPD-13025|GUANOSINE|Pi|WATER
RXN-14513.p	ADENOSINE|CPD-3705|Pi|WATER
RXN-14514.p	CPD-239|CPD-3721|Pi|WATER
RXN-14515.c	BETA-D-FRUCTOSE
RXN-14521.p	CPD-3732|Pi|THYMIDINE|WATER
RXN-14522.p	DEOXYCYTIDINE|Pi|WATER
RXN-14523.p	DEOXYURIDINE|Pi|WATER
RXN-14524.p	DEOXYADENOSINE|Pi|WATER
RXN-14525.p	DEOXYGUANOSINE|Pi|WATER
RXN-14534.p	CPD-3728|Pi|TYR|WATER
RXN-14555.c	CH33ADO|MET|S-ADENOSYLMETHIONINE|Sulfurated-Sulfur-Acceptors|Unsulfurated-Sulfur-Acceptors
RXN-14556.c	ADENOSYL-HOMO-CYS|PROTON|S-ADENOSYLMETHIONINE
RXN-14712.c	C6|Peptidoglycans|UNDECAPRENYL-DIPHOSPHATE
RXN-14810.c	TAGATOSE
RXN-14811.c	CPD-9569
RXN-14812.c	FRUCTOSE-6P
RXN-14815.c	MANNOSE-6P
RXN-14850.c	ALTROSE
RXN-14904.c	CPD0-1108
RXN-14992.c	ADENOSYL-HOMO-CYS|PROTON|S-ADENOSYLMETHIONINE
RXN-15041.c	All-tRNAs|D-Amino-Acids|PROTON|WATER
RXN-15119.p	Acceptor|CPD-4544|Donor-H2
RXN-15122.c	PROTON|THR|WATER
RXN-15123.c	2-OXOBUTANOATE|AMMONIUM|PROTON|WATER
RXN-15125.c	PROTON|SER|WATER
RXN-15127.c	AMMONIUM|PROTON|PYRUVATE|WATER
RXN-15129.c	CYS|HS|PROTON
RXN-15131.c	HOMO-CYS|L-CYSTATHIONINE|PROTON
RXN-15139.c	ADENINE|CPD-12377|CPD0-2461|PROTON
RXN-15140.c	CPD-12377|DEOXYADENOSINE|PROTON
RXN-15147.c	O-SUCCINYL-L-HOMOSERINE|PROTON|SUC
RXN-15210.p	DIACYLGLYCEROL|L-1-PHOSPHATIDYL-ETHANOLAMINE
RXN-15292.c	FE+2|HYDROGEN-PEROXIDE|OXYGEN-MOLECULE|PROTON|WATER
RXN-15293.c	FE+2|HYDROGEN-PEROXIDE|PROTON|WATER
RXN-15294.c	FE+2|OXYGEN-MOLECULE|PROTON|WATER
RXN-15297.c	ADP|ATP|PROTON
RXN-15298.c	DIHYDROXY-ACETONE-PHOSPHATE
RXN-15299.c	NAD|NADH|PROTON
RXN-15312.c	ALPHA-GLC-6-P|ALPHA-GLUCOSE|Pi|WATER
RXN-15313.c	CPD0-1123|N-ACETYL-D-MANNOSAMINE|PYRUVATE
RXN-15314.cp	CPD0-1123|PROTON
RXN-15315.ce	CPD0-1123
RXN-15315.cp	CPD0-1123
RXN-1623.p	ACYL-SN-GLYCEROL-3P|CO-A|L-PHOSPHATIDATE
RXN-1961.c	AMP|ATP|LYS|Lysidine-tRNA-Ile2|PPI|PROTON
RXN-2043.e	CELLULOSE|Cellodextrins|WATER
RXN-2881.c	FORMALDEHYDE|METHYLENE-THF|THF|WATER
RXN-2961.c	FORMALDEHYDE|GLUTATHIONE|S-HYDROXYMETHYLGLUTATHIONE
RXN-2962.c	CPD-548|NAD-P-OR-NOP|NADH-P-OR-NOP|PROTON|S-HYDROXYMETHYLGLUTATHIONE
RXN-3521.c	ASCORBATE|CPD-318|HYDROGEN-PEROXIDE|PROTON|WATER
RXN-3523.c	ASCORBATE|CPD-318|L-DEHYDRO-ASCORBATE|PROTON
RXN-3641.c	3-KETO-ADIPYL-COA|ACETYL-COA|CO-A|SUC-COA
RXN-4821.c	DELTA1-PIPERIDEINE-2-6-DICARBOXYLATE|L-ALPHA-AMINO-EPSILON-KETO-PIMELATE|PROTON|WATER
RXN-5068.ce	EG11489-MONOMER
RXN-5076.cp	PROTON|XANTHINE
RXN-5077.c	APS|G7071-MONOMER|MONOMER-2720
RXN-5647.p	CHOLINE|PHOSPHORYL-CHOLINE|Pi|WATER
RXN-5741.p	ACP|AMP|ATP|CPD-195|Octanoyl-ACPs|PPI
RXN-5822.c	NAD|NADP|Pi|WATER
RXN-5841.c	NICOTINAMIDE_NUCLEOTIDE|NICOTINAMIDE_RIBOSE|Pi|WATER
RXN-6081.c	2-ACETO-LACTATE|Acceptor|CARBON-DIOXIDE|DIACETYL|Donor-H2|PROTON
RXN-6321.c	5-10-METHENYL-THF|5-FORMYL-THF|PROTON|WATER
RXN-6423.c	4-AMINO-BUTYRALDEHYDE|CPD-6124|WATER
RXN-6622.c	CYS|CYS-GLY|GLY|WATER
RXN-6622.p	CYS|CYS-GLY|GLY|WATER
RXN-7101.c	BCCP-biotin-monomers|BCCP-dimers
RXN-7282.c	CPD-6761|OXOPENTENOATE
RXN-7605.c	ADENOSYL-HOMO-CYS|Demethylated-methyl-acceptors|Methylated-methyl-acceptors|S-ADENOSYLMETHIONINE
RXN-7607.c	IMP|INOSINE|Pi|WATER
RXN-7609.c	GMP|GUANOSINE|Pi|WATER
RXN-7682.c	HYPOXANTHINE|NAD|NADH|PROTON|WATER|XANTHINE
RXN-7716.c	NAD|NADH|Oxo-glutarate-dehydrogenase-DH-lipoyl|Oxo-glutarate-dehydrogenase-lipoyl|PROTON
RXN-7800.c	2K-4CH3-PENTANOATE|CARBON-DIOXIDE|CPD-7100|PROTON
RXN-7913.c	ADP|ATP|DCDP|DCMP
RXN-7931.c	CPD-7222
RXN-7948.p	ETHANOL-AMINE|PHOSPHORYL-ETHANOLAMINE|Pi|WATER
RXN-7967.c	DEHYDROQUINATE|NAD-P-OR-NOP|NADH-P-OR-NOP|PROTON|QUINATE
RXN-7968.c	3-DEHYDRO-SHIKIMATE|NAD-P-OR-NOP|NADH-P-OR-NOP|PROTON|SHIKIMATE
RXN-8073.c	HEME_D|HYDROGEN-PEROXIDE|PROTOHEME
RXN-8315.c	HSO3|PROTON|SO3
RXN-8340.c	GTP|PPI|PRECURSOR-Z
RXN-8342.c	CPD-4|MPT-Synthases|PRECURSOR-Z|Thiocarboxylated-MPT-synthases|WATER
RXN-8344.c	ATP|CPD-4|CPD-8122|PPI|PROTON
RXN-8348.c	AMP|CPD-3|CPD-8122|CPD-8123|PROTON|WATER
RXN-8447.c	1-AMINO-PROPAN-2-ONE-3-PHOSPHATE|2-AMINO-3-OXO-4-PHOSPHONOOXYBUTYRATE|CARBON-DIOXIDE|PROTON
RXN-8629.c	DIHYDROLIPOYL-GCVH|NAD|NADH|PROTEIN-LIPOYLLYSINE|PROTON
RXN-8632.c	ACETOL|NAD|NADH|PROPANE-1-2-DIOL|PROTON
RXN-8638.cp	ADP|ATP|PROTON|Pi|Quaternary-Amines|WATER
RXN-8642.c	2-KETOGLUTARATE|CARBON-DIOXIDE|OXALO-SUCCINATE|PROTON
RXN-8645.c	2-HYDROXYGLUTARIC_ACID|2-KETOGLUTARATE|NAD|NADH|PROTON
RXN-8654.c	ATP|LIPOIC-ACID|LIPOYL-AMP|PPI|PROTON
RXN-8655.c	AMP|LIPOYL-AMP|Lipoyl-Protein|Lipoyl-Protein-N6-lipoyllysine|PROTON
RXN-8667.c	Acceptor|Donor-H2|HYDROGEN-PEROXIDE|WATER
RXN-8668.c	Ox-Thioredoxin|Protein-L-Methionine-S-Oxides|Protein-L-methionine|Red-Thioredoxin|WATER
RXN-8675.c	ADENOSYL-HOMO-CYS|CPD-9038|DIHYDROSIROHYDROCHLORIN|S-ADENOSYLMETHIONINE
RXN-8770.c	ADENOSYLCOBALAMIN|ADENOSYLCOBALAMIN-5-P|Pi|WATER
RXN-8899.c	AMMONIUM|PROTON|PYRUVATE|WATER
RXN-8974.c	3-HYDROXY-PROPIONATE|MALONATE-S-ALD|NADP|NADPH|PROTON
RXN-8991.c	2-D-THREO-HYDROXY-3-CARBOXY-ISOCAPROATE|CPD-9451|WATER
RXN-8992.c	DELTA3-ISOPENTENYL-PP|FARNESYL-PP|OCTAPRENYL-DIPHOSPHATE|PPI
RXN-8999.c	DELTA3-ISOPENTENYL-PP|FARNESYL-PP|PPI|UNDECAPRENYL-DIPHOSPHATE
RXN-9310.c	CPD-9923|CPD-9924|PYRUVATE
RXN-9311.c	CO-A|CPD-9925|DIHYDROXYNAPHTHOATE|PROTON|WATER
RXN-9514.c	Acetoacetyl-ACPs|Beta-3-hydroxybutyryl-ACPs|NADP|NADPH|PROTON
RXN-9516.c	3-oxo-hexanoyl-ACPs|ACP|Butanoyl-ACPs|CARBON-DIOXIDE|MALONYL-ACP|PROTON
RXN-9518.c	3-oxo-hexanoyl-ACPs|NADP|NADPH|PROTON|R-3-hydroxyhexanoyl-ACPs
RXN-9520.c	Hex-2-enoyl-ACPs|R-3-hydroxyhexanoyl-ACPs|WATER
RXN-9523.c	3-Oxo-octanoyl-ACPs|ACP|CARBON-DIOXIDE|Hexanoyl-ACPs|MALONYL-ACP|PROTON
RXN-9524.c	3-Hydroxy-octanoyl-ACPs|3-Oxo-octanoyl-ACPs|NADP|NADPH|PROTON
RXN-9527.c	3-oxo-decanoyl-ACPs|ACP|CARBON-DIOXIDE|MALONYL-ACP|Octanoyl-ACPs|PROTON
RXN-9528.c	3-oxo-decanoyl-ACPs|Beta-hydroxydecanoyl-ACPs|NADP|NADPH|PROTON
RXN-9531.c	3-oxo-dodecanoyl-ACPs|ACP|CARBON-DIOXIDE|Decanoyl-ACPs|MALONYL-ACP|PROTON
RXN-9532.c	3-oxo-dodecanoyl-ACPs|NADP|NADPH|PROTON|R-3-hydroxydodecanoyl-ACPs
RXN-9533.c	Dodec-2-enoyl-ACPs|R-3-hydroxydodecanoyl-ACPs|WATER
RXN-9535.c	3-oxo-myristoyl-ACPs|ACP|CARBON-DIOXIDE|Dodecanoyl-ACPs|MALONYL-ACP|PROTON
RXN-9536.c	3-oxo-myristoyl-ACPs|NADP|NADPH|PROTON|R-3-hydroxymyristoyl-ACPs
RXN-9537.c	R-3-hydroxymyristoyl-ACPs|Tetradec-2-enoyl-ACPs|WATER
RXN-9539.c	3-oxo-palmitoyl-ACPs|ACP|CARBON-DIOXIDE|MALONYL-ACP|Myristoyl-ACPs|PROTON
RXN-9540.c	3-oxo-palmitoyl-ACPs|NADP|NADPH|PROTON|R-3-Hydroxypalmitoyl-ACPs
RXN-9549.c	ACP|PALMITATE|PROTON|Palmitoyl-ACPs|WATER
RXN-9550.p	ACP|CPD-9245|PROTON|Palmitoleoyl-ACPs|WATER
RXN-9555.p	ACP|CPD-9247|Cis-vaccenoyl-ACPs|PROTON|WATER
RXN-9556.c	3-oxo-cis-vaccenoyl-ACPs|NADP|NADPH|PROTON|R-3-hydroxy-cis-vaccenoyl-ACPs
RXN-9557.c	R-3-hydroxy-cis-vaccenoyl-ACPs|WATER|cis-vaccen-2-enoyl-ACPs
RXN-9558.c	Cis-vaccenoyl-ACPs|NAD|NADH|PROTON|cis-vaccen-2-enoyl-ACPs
RXN-9597.p	AMMONIUM|Aldehydes|HYDROGEN-PEROXIDE|OXYGEN-MOLECULE|Primary-Amines|WATER
RXN-9655.c	Beta-hydroxydecanoyl-ACPs|Trans-D2-decenoyl-ACPs|WATER
RXN-9657.c	Butanoyl-ACPs|Crotonyl-ACPs|NAD|NADH|PROTON
RXN-9658.c	Hex-2-enoyl-ACPs|Hexanoyl-ACPs|NAD|NADH|PROTON
RXN-9659.c	2-Octenoyl-ACPs|NAD|NADH|Octanoyl-ACPs|PROTON
RXN-9660.c	Decanoyl-ACPs|NAD|NADH|PROTON|Trans-D2-decenoyl-ACPs
RXN-9661.c	Dodec-2-enoyl-ACPs|Dodecanoyl-ACPs|NAD|NADH|PROTON
RXN-9662.c	Myristoyl-ACPs|NAD|NADH|PROTON|Tetradec-2-enoyl-ACPs
RXN-9663.c	2-Hexadecenoyl-ACPs|NAD|NADH|PROTON|Palmitoyl-ACPs
RXN-9772.c	FUM|IMINOASPARTATE|L-ASPARTATE|PROTON|SUC
RXN-9787.c	CYS|L-ALPHA-ALANINE|Sulfur-Carrier-Proteins-ThiI
RXN-9788.c	AMP|Adenylated-ThiS-Proteins|Sulfur-Carrier-Proteins-ThiI|Thiocarboxyadenylated-ThiS-Proteins
RXN-9789.c	ATP|Adenylated-ThiS-Proteins|PPI|Thi-S
RXN-9790.c	Sulfur-Carrier-Proteins-ThiI|ThiF-Proteins|ThiS-ThiF-disulfides|ThiS-ThiI-disulfides
RXN-982.c	ARSENATE|CPD-763|Ox-Glutaredoxins|PROTON|Red-Glutaredoxins|WATER
RXN-9951.c	NADP|NADPH|OXALO-SUCCINATE|PROTON|THREO-DS-ISO-CITRATE
RXN-9952.c	CARBON-DIOXIDE|CPD-2961|NADP|NADPH|RIBULOSE-5P
RXN0-0.ce	N-ACETYLNEURAMINATE
RXN0-0.cp	N-ACETYLNEURAMINATE
RXN0-10.cp	CD+2
RXN0-1001.p	CPD-534|MI-HEXAKISPHOSPHATE|Pi|WATER
RXN0-1061.c	ADP|ATP|PROTON|Pi|WATER
RXN0-1081.c	AMMONIUM|PROTON|WATER|tRNA-Arg-adenosine34|tRNA-Arg-inosine34
RXN0-11.cp	ADP|ATP|GLUTATHIONE|PROTON|Pi|WATER
RXN0-1130.c	ACEF-LIPOATE|ACP|E2P-MONOMER|LIPOYL-ACP
RXN0-1132.c	NAD|NADH|PROTON|Pyruvate-dehydrogenase-dihydrolipoate|Pyruvate-dehydrogenase-lipoate
RXN0-1133.c	ACETYL-COA|CO-A|Pyruvate-dehydrogenase-acetylDHlipoyl|Pyruvate-dehydrogenase-dihydrolipoate
RXN0-1134.c	CARBON-DIOXIDE|PROTON|PYRUVATE|Pyruvate-dehydrogenase-acetylDHlipoyl|Pyruvate-dehydrogenase-lipoate
RXN0-1137.c	ACP|E2O-MONOMER|LIPOYL-ACP|SUCB-LIPOATE
RXN0-1138.c	ACP|Apo-GcvH|Lipoyl-ACPs|PROTEIN-LIPOYLLYSINE
RXN0-1139.c	ACEF-LIPOATE|AMP|ATP|E2P-MONOMER|LIPOIC-ACID|PPI
RXN0-1140.c	AMP|ATP|E2O-MONOMER|LIPOIC-ACID|PPI|SUCB-LIPOATE
RXN0-1141.c	AMP|ATP|Apo-GcvH|LIPOIC-ACID|PPI|PROTEIN-LIPOYLLYSINE|PROTON
RXN0-1144.c	2-KETOGLUTARATE|CARBON-DIOXIDE|SUCB-LIPOATE|SUCB-S-SUCCINYLDIHYDROLIPOATE
RXN0-1147.c	CO-A|Oxo-glutarate-dehydro-suc-DH-lipoyl|Oxo-glutarate-dehydrogenase-DH-lipoyl|SUC-COA
RXN0-12.cp	ZN+2
RXN0-1241.c	ADENOSYL-HOMO-CYS|PROTON|S-ADENOSYLMETHIONINE
RXN0-1281.c	NADP|NADPH|PROTON|tRNA-Dihydrouridines
RXN0-1321.c	7-AMINOMETHYL-7-DEAZAGUANINE|GUANINE|tRNA-with-7-aminomethyl-7-deazaguanine
RXN0-1342.c	ADENINE|MET|PROTON|S-ADENOSYLMETHIONINE|tRNA-with-7-aminomethyl-7-deazaguanine|tRNAs-containing-epoxy-quenosine
RXN0-1382.c	FORMATE|FORMYL-COA|OXALATE|OXALYL-COA
RXN0-14.cp	CU+2
RXN0-1401.c	ADP|ATP|PRPP|RIBOSE-15-BISPHOSPHATE
RXN0-1402.c	ADP|ATP|PROTON|RIBOSE-15-BISPHOSPHATE|RIBOSE-1P
RXN0-1441.c	ADENOSINE_DIPHOSPHATE_RIBOSE|AMP|PROTON|RIBOSE-5P|WATER
RXN0-1461.c	CARBON-DIOXIDE|COPROPORPHYRINOGEN_III|OXYGEN-MOLECULE|PROTON|PROTOPORPHYRINOGEN|WATER
RXN0-1483.c	FE+2|FE+3|OXYGEN-MOLECULE|PROTON|WATER
RXN0-1483.p	FE+2|FE+3|OXYGEN-MOLECULE|PROTON|WATER
RXN0-1565.ce	COB-I-ALAMIN
RXN0-1565.cp	COB-I-ALAMIN
RXN0-16.cp	MN+2
RXN0-1602.c	DIMP|DITP|PPI|PROTON|WATER
RXN0-1603.c	PPI|PROTON|WATER|XANTHOSINE-5-PHOSPHATE|XTP
RXN0-1641.c	EG11149-MONOMER|GLY|MONOMER0-941
RXN0-1661.c	ENTEROBACTIN|N-23-DIHYDROXYBENZOYL-L-SERINE|PROTON|WATER
RXN0-1682.ce	FERRIC-ENTEROBACTIN-COMPLEX
RXN0-1684.ce	FERRIC-CITRATE-COMPLEX
RXN0-1684.cp	FERRIC-CITRATE-COMPLEX
RXN0-17.cp	CPD0-881|NACMUR|PTSH-MONOMER|PTSH-PHOSPHORYLATED
RXN0-1701.ce	CPD0-2241
RXN0-1702.ce	CPD0-621
RXN0-1702.cp	CPD0-621
RXN0-1721.ce	CPD0-2482
RXN0-1721.cp	CPD0-2482
RXN0-1741.ce	MALTOSE
RXN0-1741.cp	MALTOSE
RXN0-18.cp	INOSINE|PROTON
RXN0-1802.ce	Long-Chain-Fatty-Acids
RXN0-1802.cp	Long-Chain-Fatty-Acids
RXN0-1804.ce	Unspecified-Ion-Or-Solute
RXN0-1804.cp	Unspecified-Ion-Or-Solute
RXN0-1842.c	A-GLYCEROL-ESTER|HEPTA-ACYLATED-LIPID-A|KDO2-LIPID-A|Phospholipids
RXN0-1861.c	5-BETA-L-THREO-PENTAPYRANOSYL-4-ULOSE-|CARBON-DIOXIDE|NAD|NADH|UDP-GLUCURONATE
RXN0-1862.c	10-FORMYL-THF|PROTON|THF|UDP-4-AMINO-4-DEOXY-L-ARABINOSE|UDP-L-ARA4-FORMYL-N
RXN0-1863.c	2-KETOGLUTARATE|5-BETA-L-THREO-PENTAPYRANOSYL-4-ULOSE-|GLT|UDP-4-AMINO-4-DEOXY-L-ARABINOSE
RXN0-1882.c	D-TYROSINE|TYR-tRNAs|WATER
RXN0-1922.c	CPD-8521|CPD0-1208|DNA-containing-abasic-Sites|WATER
RXN0-1923.cp	ACETYLSERINE
RXN0-1924.cp	CYS
RXN0-1941.c	ETHYL-2-METHYLACETOACETATE|ETHYL-2R-METHYL-3S-HYDROXYBUTANOATE|NADP|NADPH|PROTON
RXN0-1981.cp	ACET
RXN0-1982.cp	GLYOX
RXN0-20.p	Diacylglycerol-Prolipoproteins|L-1-PHOSPHATIDYL-GLYCEROL|Prolipoproteins|SN-GLYCEROL-1-PHOSPHATE
RXN0-2001.p	CPD-9646|CPD0-1189|KDO2-LIPID-A|L-ARA4N-MODIFIED-KDO2-LIPID-A
RXN0-2022.c	ACETALD|ACETOIN|CARBON-DIOXIDE|PROTON|PYRUVATE
RXN0-2023.c	AMP|ATP|PPI|TusE-L-cysteine|TusE-S-sulfanylcysteine|tRNA-2-thiouridine34|tRNA-uridine34
RXN0-2042.c	CPD-207|CPD0-2362|NADP|NADPH|OXYGEN-MOLECULE|PROTON|WATER
RXN0-2044.c	3-HYDROXYADIPYL-COA|3-KETO-ADIPYL-COA|NAD|NADH|PROTON
RXN0-2061.c	D-ALANINE|UDP-AAGM-DIAMINOHEPTANEDIOATE|UDP-MURNAC-TETRAPEPTIDE|WATER
RXN0-21.cp	ADP|ATP|GLUTATHIONE|PROTON|Pi|WATER
RXN0-2101.c	Acceptor|Donor-H2|SELENATE|SELENITE|WATER
RXN0-2121.ce	COB-I-ALAMIN
RXN0-2141.c	ACP|CARBON-DIOXIDE|Cis-delta-3-decenoyl-ACPs|MALONYL-ACP|PROTON|b-Keto-cis-D5-dodecenoyl-ACPs
RXN0-2142.c	NADP|NADPH|PROTON|b-Hydroxy-cis-D5-dodecenoyl-ACPs|b-Keto-cis-D5-dodecenoyl-ACPs
RXN0-2144.c	Trans-D3-cis-D5-dodecenoyl-ACPs|WATER|b-Hydroxy-cis-D5-dodecenoyl-ACPs
RXN0-2145.c	Cis-Delta5-dodecenoyl-ACPs|NAD|NADH|PROTON|Trans-D3-cis-D5-dodecenoyl-ACPs
RXN0-2161.c	AMP|ATP|L-seryl-SEC-tRNAs|PPI|PROTON|SEC-tRNAs|SER
RXN0-2162.cp	AGMATHINE|ARG
RXN0-2181.ce	FERRIC-ENTEROBACTIN-COMPLEX
RXN0-22.cp	GUANOSINE|PROTON
RXN0-2201.c	2-AMINOMALONATE-SEMIALDEHYDE|NADP|NADPH|PROTON|SER
RXN0-2241.ce	CPD0-2241
RXN0-2261.ce	FERRIC-CITRATE-COMPLEX
RXN0-2281.c	Mnm5Se2U-containing-tRNAs|SEPO3|tRNA-Containing-5MeAminoMe-2-ThioU
RXN0-2301.c	3-METHYL-CROTONYL-COA|ETF-Oxidized|ETF-Reduced|ISOVALERYL-COA
RXN0-2361.c	ADP|ATP|L-ALA-GAMMA-D-GLU-DAP|PROTON|Pi|UDP-AAGM-DIAMINOHEPTANEDIOATE|UDP-N-ACETYLMURAMATE
RXN0-2361.e	ADP|ATP|L-ALA-GAMMA-D-GLU-DAP|PROTON|Pi|UDP-AAGM-DIAMINOHEPTANEDIOATE|UDP-N-ACETYLMURAMATE
RXN0-2381.c	GAP|INDOLE|INDOLE-3-GLYCEROL-P
RXN0-2382.c	INDOLE|SER|TRP|WATER
RXN0-2421.cp	FE+2|PROTON
RXN0-2441.c	ADENOSYL-HOMO-CYS|CPD-225|MONOMETHYL-ESTER-OF-TRANS-ACONITATE|S-ADENOSYLMETHIONINE
RXN0-2461.cp	ASCORBATE|L-ASCORBATE-6-PHOSPHATE|PTSH-MONOMER|PTSH-PHOSPHORYLATED
RXN0-2481.ce	Hydrophilic-Solute-Or-Ion-LT-600Da
RXN0-2481.cp	Hydrophilic-Solute-Or-Ion-LT-600Da
RXN0-2501.cp	CL-|PROTON
RXN0-2522.cp	2-O-ALPHA-MANNOSYL-D-GLYCERATE|CPD0-1063|PTSH-MONOMER|PTSH-PHOSPHORYLATED
RXN0-2542.ce	Mono-Di-And-Tri-Saccharides-LT-600Da
RXN0-2542.cp	Mono-Di-And-Tri-Saccharides-LT-600Da
RXN0-2561.cp	Drugs|NA+
RXN0-2584.c	AP-Site-Created|DNA-with-Uracils|URACIL|WATER
RXN0-2601.c	DNA-containing-a-Apyrimidinic-Sites|Damaged-DNA-Pyrimidine
RXN0-2604.c	DNA-Segment-Placeholder|DNA-with-Holiday-Junctions
RXN0-2605.c	5-phosphooligonucleotides|Double-Stranded-DNAs
RXN0-2606.c	Stabilized-RecA-Filament-DNA-Complex|Unstable-RecA-Filament-DNA-Complex
RXN0-261.c	LEU|MONOMER0-155|PD00353
RXN0-262.c	CPD-582|CPD-8123|GTP|PPI|PROTON
RXN0-2621.c	CPD-8180|CPD-8534
RXN0-2622.c	CPD-8180|CPD-8181
RXN0-2625.c	CPD-8199|CPD-8200
RXN0-266.c	EG20253-MONOMER|MONOMER0-165|XYLOSE
RXN0-2661.c	DNA-With-G-A-Mismatch|DNA-With-Mismatched-Adenine
RXN0-267.p	HYDROGEN-PEROXIDE|Ox-Thioredoxin|Red-Thioredoxin|WATER
RXN0-268.c	PROPIONATE|PROPIONYL-COA|SUC|SUC-COA
RXN0-269.c	CAMP|CPLX0-226|PC00004
RXN0-2701.c	5-DEHYDROGLUCONATE|G7891-MONOMER|MONOMER0-1301
RXN0-271.c	ETR-Quinols|ETR-Quinones|NADP|NADPH|PROTON
RXN0-272.c	ARG|CPLX0-228|PC00005
RXN0-2721.c	CPLX0-1|CPLX0-2|NAD|NADH|NITRIC-OXIDE|NITROUS-OXIDE|WATER
RXN0-275.c	CPD-8524|PHENYLHYDANTOIN|WATER
RXN0-278.c	MONOMER-56|PD00283|SORBITOL
RXN0-2787.c	CPD-4|EG11597-MONOMER|MONOMER0-4125|PRECURSOR-Z
RXN0-279.c	3-SULFINOALANINE|L-ALPHA-ALANINE|PROTON|SO3|WATER
RXN0-280.c	Aldehydes|Alkanesulfonates|FMN|FMNH2|OXYGEN-MOLECULE|PROTON|SO3|WATER
RXN0-281.c	MONOMER0-157|PD04032|S-ADENOSYLMETHIONINE
RXN0-283.c	MONOMER0-46|NA+|PD00474
RXN0-284.c	CPLX-123|HYPOXANTHINE|PC00033
RXN0-2841.c	3-HYDROXYPHENYL-PROPIONATE|G6201-MONOMER|MONOMER0-1441
RXN0-285.c	MONOMER-47|PD00222|RHAMNOSE
RXN0-286.c	CPLX-124|PC00086|RHAMNOSE
RXN0-287.c	CPLX-125|PC00007|TRP
RXN0-288.c	CHOLINE|MONOMER0-49|PD00251
RXN0-289.c	MONOMER-57|PD04099|PHOSPHO-ENOL-PYRUVATE
RXN0-290.c	CPD-110|MONOMER-58|PD00364
RXN0-291.c	EG11088-MONOMER|MONOMER-59|PYRUVATE
RXN0-2921.c	ADP|ATP|GLT|METHYLENE-THF-GLU-N|Pi
RXN0-293.c	ATP|MONOMER0-160|PD03831
RXN0-294.c	MELIBIOSE|MONOMER0-161|PD00208
RXN0-2941.c	Cleaved-DNA|DNA-With-Recognition-Site
RXN0-2942.c	DNA-Cleaved-Recognition-Site|DNA-With-Recognition-Site
RXN0-2943.p	2-3-DIHYDROXYBENZOATE|2-CARBOXYMUCONATE|OXYGEN-MOLECULE|PROTON
RXN0-2945.p	CU+|CU+2|OXYGEN-MOLECULE|PROTON|WATER
RXN0-295.c	ARABINOSE|CPLX-172|PC00003
RXN0-296.c	MONOMER0-162|PD00413|TYR
RXN0-298.c	CPD-69|MONOMER0-164|PD00291
RXN0-299.c	2-KETOGLUTARATE|CARBON-DIOXIDE|CPD-1772|OXYGEN-MOLECULE|PROTON|SO3|SUC|TAURINE
RXN0-3.cp	ADP|ATP|CYS|PROTON|Pi|WATER
RXN0-300.c	GLYCERATE|NADP|NADPH|OH-PYR|PROTON
RXN0-300.p	GLYCERATE|NADP|NADPH|OH-PYR|PROTON
RXN0-3001.c	ACETYLSERINE|CPLX0-2781|PC00040
RXN0-3002.c	MALK-MONOMER|MONOMER0-1761|PD00237
RXN0-301.c	FORMALDEHYDE|HYDROGEN-PEROXIDE|N-METHYLTRYPTOPHAN|OXYGEN-MOLECULE|TRP|WATER
RXN0-302.c	2-PHOSPHO-4-CYTIDINE-5-DIPHOSPHO-2-C-MET|2C-METH-D-ERYTHRITOL-CYCLODIPHOSPHATE|CMP
RXN0-3021.c	EG11519-MONOMER|MONOMER0-1781|NI+2
RXN0-303.c	D-ALLOSE-6-PHOSPHATE|D-ALLULOSE-6-PHOSPHATE
RXN0-304.c	D-ALLULOSE-6-PHOSPHATE|FRUCTOSE-6P
RXN0-305.c	OH-PYR|TARTRONATE-S-ALD
RXN0-307.c	NAD|NADH|Ox-Hybrid-Cluster-Proteins|Red-Hybrid-Cluster-Proteins
RXN0-308.c	CYS|L-ALPHA-ALANINE|L-Cysteine-Desulfurases|Persulfurated-L-cysteine-desulfurases
RXN0-310.c	CARBON-DIOXIDE|METHYL-MALONYL-COA|PROPIONYL-COA|PROTON
RXN0-312.c	ARCB-MONOMER|PHOSPHO-ARCB717|Pi|WATER
RXN0-313.c	DIHYDROXYACETONE|FRUCTOSE-6P|GAP
RXN0-3141.c	CPLX0-2821|MONOMER0-1641|TORR-CPLX
RXN0-3182.p	POLYPEPTIDE|WATER
RXN0-3201.p	WATER|cleaved-lipoprotein-signal-peptide
RXN0-321.ce	BARA-MONOMER|EG11140-MONOMER|MONOMER0-1
RXN0-3221.p	General-Protein-Substrates|WATER
RXN0-3241.c	Amino-Acids-20|CPD-12991|L-ASPARTATE|WATER
RXN0-3261.p	ARG|General-Protein-Substrates|WATER
RXN0-3281.c	Acceptor|CARBON-DIOXIDE|Donor-H2|FORMATE|PROTON
RXN0-3281.e	Acceptor|CARBON-DIOXIDE|Donor-H2|FORMATE|PROTON
RXN0-3283.c	E-|HYDROGEN-MOLECULE|PROTON
RXN0-3341.c	ACET|ACETYL-P|EG12121-MONOMER|RSSB-P
RXN0-3364.c	C-terminal-32-aminoacid-Peptides|Precursor-of-hydrogenase-3|WATER|a-precursor-of-large-subunit-of-hydrogen
RXN0-3381.c	CR+3|CR+6|HYDROGEN-PEROXIDE|NAD-P-OR-NOP|NADH-P-OR-NOP|OXYGEN-MOLECULE
RXN0-3441.c	CPD-3766|MENADIOL|OXYGEN-MOLECULE|PROTON|SUPER-OXIDE
RXN0-3461.p	CPD0-1181|CPD0-1182|CPD0-1183|WATER
RXN0-3501.cp	Menaquinols|Menaquinones|NITRATE|NITRITE|PROTON|WATER
RXN0-3521.p	CPD-9646|CPD0-888|UDP|UDP-L-ARA4-FORMYL-N
RXN0-3542.c	PROTON|Pi|THIAMINE-P|THIAMINE-PYROPHOSPHATE|WATER
RXN0-3543.c	AMINO-HYDROXYMETHYL-METHYL-PYR-P|AMINO-HYDROXYMETHYL-METHYLPYRIMIDINE-PP|PROTON|Pi|WATER
RXN0-3601.c	CARNITINE|GAMMA-BUTYROBETAINE|GAMMA-BUTYROBETAINYL-COA|L-CARNITINYL-COA
RXN0-361.c	CYTIDINE|CYTOSINE|WATER
RXN0-363.c	WATER|XANTHINE|XANTHOSINE
RXN0-3741.c	Deoxy-Ribonucleoside-Monophosphates|Deoxy-Ribonucleosides|Pi|WATER
RXN0-3741.p	Deoxy-Ribonucleoside-Monophosphates|Deoxy-Ribonucleosides|Pi|WATER
RXN0-382.c	ADP|ATP|CPD-1093|DEOXYXYLULOSE-5P|PROTON
RXN0-383.c	CMP|CTP|PPI|PROTON|WATER
RXN0-384.c	DAMP|DATP|PPI|PROTON|WATER
RXN0-385.c	DGMP|DGTP|PPI|PROTON|WATER
RXN0-3901.c	ADP|ATP|GAMMA-GLUTAMYL-PUTRESCINE|GLT|PROTON|PUTRESCINE|Pi
RXN0-3921.c	AMMONIUM|GAMMA-GLUTAMYL-GAMMA-AMINOBUTYRALDEH|GAMMA-GLUTAMYL-PUTRESCINE|HYDROGEN-PEROXIDE|OXYGEN-MOLECULE|WATER
RXN0-3922.c	CPD-9000|GAMMA-GLUTAMYL-GAMMA-AMINOBUTYRALDEH|NAD-P-OR-NOP|NADH-P-OR-NOP|PROTON|WATER
RXN0-3942.c	4-AMINO-BUTYRATE|CPD-9000|GLT|WATER
RXN0-3962.c	ACET|ACETALD|NADP|NADPH|PROTON|WATER
RXN0-4022.c	7-AMINOMETHYL-7-DEAZAGUANINE|7-CYANO-7-DEAZAGUANINE|NADP|NADPH|PROTON
RXN0-4083.cp	NA+|SER
RXN0-4101.c	3-PHENYLPROPIONATE|G7331-MONOMER|MONOMER0-2081
RXN0-4121.c	CPD0-1442|GMP|GMP-LYSINE-PHOSPHORAMIDATE|WATER
RXN0-4161.c	EG20249-MONOMER|FRUCTURONATE|MONOMER0-2101
RXN0-4181.p	C-DI-GMP|L-DI-GMP|PROTON|WATER
RXN0-4222.c	CPD0-2351|CPD0-2354|Ribonucleoside-Monophosphates|WATER
RXN0-4223.c	Nucleoside-Monophosphates|RNA-Holder|WATER
RXN0-4261.c	ADP|ATP|Pi|Single-Stranded-DNAs|Supercoiled-Duplex-DNAs
RXN0-4261.n	ADP|ATP|Pi|Single-Stranded-DNAs|Supercoiled-Duplex-DNAs
RXN0-4281.c	ACETOL|METHYL-GLYOXAL|NADP|NADPH|PROTON
RXN0-4301.c	D-ALPHABETA-D-HEPTOSE-7-PHOSPHATE|D-SEDOHEPTULOSE-7-P
RXN0-4322.c	G7854-MONOMER|L-ASCORBATE-6-PHOSPHATE|MONOMER0-2162
RXN0-4341.c	ADP|ATP|D-ALPHABETA-D-HEPTOSE-7-PHOSPHATE|D-BETA-D-HEPTOSE-17-DIPHOSPHATE|PROTON
RXN0-4342.c	ADP-D-GLYCERO-D-MANNO-HEPTOSE|ATP|D-BETA-D-HEPTOSE-1-P|PPI|PROTON
RXN0-4361.c	D-BETA-D-HEPTOSE-1-P|D-BETA-D-HEPTOSE-17-DIPHOSPHATE|Pi|WATER
RXN0-4401.c	AMP|NADH|NMNH|PROTON|WATER
RXN0-443.c	FORMATE|MONOMER0-183|PD02936
RXN0-4461.p	DIACYLGLYCEROL-PYROPHOSPHATE|L-PHOSPHATIDATE|PROTON|Pi|WATER
RXN0-4462.c	G6276-MONOMER|GLYOX|MONOMER0-2201
RXN0-4481.c	G6274-MONOMER|MONOMER0-2221|S-ALLANTOIN
RXN0-4522.cp	ADP|ATP|MET|PROTON|Pi|WATER
RXN0-4581.p	DIACYLGLYCEROL|KDO2-LIPID-IVA|L-1-PHOSPHATIDYL-ETHANOLAMINE|PHOSPHATIDYLETHANOLAMINE-KDO2
RXN0-4621.c	ADP|ATP|CPD0-881|CPD0-882|PROTON|WATER
RXN0-4641.c	CPD0-881|D-LACTATE|N-ACETYL-D-GLUCOSAMINE-6-P|WATER
RXN0-4661.c	MONOMER0-2261|N-ACETYL-D-GLUCOSAMINE-6-P|PD00266
RXN0-4701.c	WATER|mRNAs
RXN0-4721.c	G7678-MONOMER|MONOMER0-2341|N-ACETYLNEURAMINATE
RXN0-4741.c	CPD-622|G6195-MONOMER|MONOMER0-2421
RXN0-4761.c	MANNITOL|MONOMER0-2461|PD00369
RXN0-4841.c	FRUCTOSELYSINE|PSICOSELYSINE
RXN0-4942.c	ALLOSE|G7821-MONOMER|MONOMER0-2482
RXN0-4961.c	DNA-N|Nucleoside-Monophosphates|WATER
RXN0-5001.c	WATER|XYLOSE|Xylans
RXN0-5021.c	Short-RNA-Fragments|Single-Stranded-DNAs
RXN0-5038.c	AMP|CAMP|PROTON|WATER
RXN0-5039.c	5-Phosphomononucleotides|Double-Stranded-DNAs|Single-Stranded-DNAs|WATER
RXN0-5040.c	CPD0-889|GLT|P-AMINO-BENZOATE|WATER
RXN0-5051.c	Amino-Acids-20|General-Protein-Substrates|WATER
RXN0-5052.c	Amino-Acids-20|General-Protein-Substrates|WATER
RXN0-5055.c	ACETYL-COA|ADP|ATP|BCCP-dimers|Carboxybiotin-BCCP|MALONYL-COA|PROTON|Pi|WATER
RXN0-5057.p	ADP|ADP-L-GLYCERO-D-MANNO-HEPTOSE|HEPTOSYL-KDO2-LIPID-IVA|KDO2-LIPID-IVA|PROTON
RXN0-5061.c	ADP|ADP-L-GLYCERO-D-MANNO-HEPTOSE|CPD0-929|CPD0-930|PROTON
RXN0-5062.c	AMP|ATP|PPI|Pre-tRNA-3-prime-half-molecules|ligated-tRNAs
RXN0-5063.c	ADENOSYL-HOMO-CYS|CH33ADO|MET|PROTON|S-ADENOSYLMETHIONINE|Sulfurated-Sulfur-Acceptors|Unsulfurated-Sulfur-Acceptors
RXN0-5065.c	34-DIHYDROXYPHENYLACETYL-COA|CO-A|CPD-782|PROTON|WATER
RXN0-5073.c	IDP|ITP|PROTON|Pi|WATER
RXN0-5074.c	PROTON|Pi|WATER|XDP|XTP
RXN0-5098.c	AMP|ATP|CPD-195|Lipoyl-Protein|Octanoylated-domains|PPI|PROTON
RXN0-5100.c	DNA-Segment-Placeholder|DNA-Segment-in-Reverse-Orientations
RXN0-5101.c	CPD0-903|N-ETHYLMALEIMIDE|NADP|NADPH|PROTON
RXN0-5103.p	General-Protein-Substrates|WATER
RXN0-5107.c	PPI|PROTON|TMP|TTP|WATER
RXN0-5108.c	GDP-MANNOSE|GMP|MANNOSE-1P|PROTON|WATER
RXN0-5111.cp	GLYCOLLATE
RXN0-5114.c	3-P-SERINE|Pi|SER|WATER
RXN0-5116.c	ADP|ATP|L-RIBULOSE|L-RIBULOSE-5-P|PROTON
RXN0-5118.p	ADP|ADP-L-GLYCERO-D-MANNO-HEPTOSE|CPD0-929|KDO2-LIPID-A|PROTON
RXN0-5120.p	CPD0-930|CPD0-932|PROTON|UDP
RXN0-5121.p	ADP|ATP|CPD0-932|CPD0-933|PROTON
RXN0-5122.p	ADP|ADP-L-GLYCERO-D-MANNO-HEPTOSE|CPD0-933|CPD0-934|PROTON
RXN0-5123.p	ADP|ATP|CPD0-934|CPD0-935|PROTON
RXN0-5124.c	CPD0-935|CPD0-936|PROTON|UDP
RXN0-5125.c	CPD0-936|CPD0-937|PROTON|UDP
RXN0-5126.c	CPD0-937|CPD0-938|PROTON|UDP
RXN0-5127.e	ADP|ADP-L-GLYCERO-D-MANNO-HEPTOSE|CPD0-938|CPD0-939|PROTON
RXN0-5128.p	CMP|CMP-KDO|CPD0-942|Lipopolysaccharides
RXN0-5129.p	CPD0-944|DTDP-RHAMNOSE|Lipopolysaccharides|TDP
RXN0-5130.cp	D-SERINE|PROTON
RXN0-5131.c	IS30-Insertion-Sequences|IS30-with-Integrated-Transposon
RXN0-5141.c	CPD-702|CPD-703|NADP|NADPH|PROTON
RXN0-5144.c	ADENOSYL-HOMO-CYS|PROTON|S-ADENOSYLMETHIONINE|tRNA-Containing-5MeAminoMe-2-ThioU
RXN0-5146.c	CPD0-1027|CPD0-971|MALTOTETRAOSE|WATER
RXN0-5177.c	EG12658-MONOMER|G7575-MONOMER|MONOMER0-2741|MONOMER0-4171
RXN0-5181.p	1-4-alpha-D-Glucan|MALTOHEXAOSE|WATER
RXN0-5182.c	GLC-1-P|MALTOTETRAOSE|MALTOTRIOSE|Pi
RXN0-5183.c	MALTOSE|MALTOTRIOSE|WATER
RXN0-5184.c	1-4-alpha-D-Glucan|GLC-1-P|Pi
RXN0-5185.c	CPD-2961|GLUCONATE|Pi|WATER
RXN0-5186.c	BETA-D-FRUCTOSE|FRU1P|Pi|WATER
RXN0-5187.c	FMN|Pi|RIBOFLAVIN|WATER
RXN0-5189.c	3-Methyl-Adenines|DNA-with-Alkylated-Adenines|WATER
RXN0-5190.c	NAcMur-Peptide-NAcGlc-Undecaprenols
RXN0-5190.e	NAcMur-Peptide-NAcGlc-Undecaprenols
RXN0-5190.p	NAcMur-Peptide-NAcGlc-Undecaprenols
RXN0-5192.c	CPD0-1032|LYS
RXN0-5194.c	General-Methyl-Protein-Substrates|General-Protein-Substrates|S-ADENOSYLMETHIONINE
RXN0-5195.p	POLYPEPTIDE|WATER
RXN0-5198.c	AMMONIA|Cytochromes-C552-Ox|Cytochromes-C552-Red|NITRITE|PROTON|WATER
RXN0-5199.c	GUANINE|GUANOSINE|Pi|RIBOSE-1P
RXN0-5200.c	2-Aminobutyrate|2-OXOBUTANOATE|Aminated-Amine-Donors|Deaminated-Amine-Donors
RXN0-5201.cp	B-ALANINE|PROTON
RXN0-5202.cp	L-ALPHA-ALANINE|PROTON
RXN0-5203.cp	CPD-2482|PROTON
RXN0-5204.c	Amino-Acids-20|General-Protein-Substrates|WATER
RXN0-5205.cp	ADP|ATP|PROTON|Pi|WATER|ZN+2
RXN0-5208.c	ADENOSYL-P4|ATP|PPI|PROTON
RXN0-5208.e	ADENOSYL-P4|ATP|PPI|PROTON
RXN0-5209.c	ADENOSINE5TRIPHOSPHO5ADENOSINE|ADP|ATP|PPI|PROTON
RXN0-5210.c	CPD0-1048|CPD0-1049|PROTON|UDP|UDP-D-GALACTO-14-FURANOSE
RXN0-5211.c	ADP|ATP|EG10443-MONOMER|HIPA-P
RXN0-5213.c	ACETOL|METHYL-GLYOXAL|NAD|NADH|PROTON
RXN0-5214.c	CPD-2343|L-ASCORBATE-6-PHOSPHATE|WATER
RXN0-5216.c	CPD0-1063|GLYCERATE|MANNOSE-6P|WATER
RXN0-5217.c	5-METHYLTHIOADENOSINE|CADAVERINE|CPD0-1065|PROTON|S-ADENOSYLMETHIONINAMINE
RXN0-5220.c	OH|PROTON|WATER
RXN0-5222.c	AMMONIUM|CARBAMATE|CARBON-DIOXIDE|PROTON
RXN0-5223.c	ADP|ATP|L-1-PHOSPHATIDYL-GLYCEROL|L-1-PHOSPHATIDYL-GLYCEROL-P|PROTON
RXN0-5224.c	CARBON-DIOXIDE|HCO3|PROTON|WATER
RXN0-5225.c	CPD0-1080|CPD0-1081|CPD0-1082|WATER
RXN0-5225.p	CPD0-1080|CPD0-1081|CPD0-1082|WATER
RXN0-5226.c	CPD0-1081|CPD0-882|N-ACETYL-D-GLUCOSAMINE|WATER
RXN0-5227.c	CPD0-1082|D-ALANINE|L-ALA-GAMMA-D-GLU-DAP|WATER
RXN0-5227.p	CPD0-1082|D-ALANINE|L-ALA-GAMMA-D-GLU-DAP|WATER
RXN0-5228.c	CPD0-1445|CPD0-2190
RXN0-5229.c	CPD0-1083|D-TAGATURONATE|NAD|NADH|PROTON
RXN0-5230.c	ALAS-MONOMER|CPLX0-7541|L-ALPHA-ALANINE
RXN0-5231.c	ACETYL-COA|CO-A|EG10873-MONOMER|MONOMER0-2811
RXN0-5234.c	ACETALD|ALLO-THR|GLY
RXN0-5238.c	CPLX0-7605|PD04099|PYRUVATE
RXN0-5239.c	CPLX0-7605|CPLX0-7606|GLYOX
RXN0-5240.c	D-ALANINE|PYRIDOXAL_PHOSPHATE|PYRIDOXAMINE-5P|PYRUVATE
RXN0-5242.c	E-|NITRATE|NITRITE|PROTON|WATER
RXN0-5244.c	E-|PROTON|Ubiquinols|Ubiquinones
RXN0-5245.c	E-|FUM|PROTON|SUC
RXN0-5248.c	E-|NAD|NADH|PROTON
RXN0-5250.c	CPLX0-7618|G7137-MONOMER|NI+2
RXN0-5251.c	CO+2|CPLX0-7619|G7137-MONOMER
RXN0-5252.c	CPLX0-7620|FE+2|PD00260
RXN0-5253.c	CARBON-DIOXIDE|E-|FORMATE|PROTON
RXN0-5254.c	E-|Menaquinols|Menaquinones|PROTON
RXN0-5255.c	E-|HYDROGEN-MOLECULE|PROTON
RXN0-5256.ce	HYDROGEN-MOLECULE|Menaquinols|Menaquinones|PROTON
RXN0-5256.cp	HYDROGEN-MOLECULE|Menaquinols|Menaquinones|PROTON
RXN0-5257.c	DIHYDROXY-ACETONE-PHOSPHATE|E-|GLYCEROL-3P|PROTON
RXN0-5259.c	E-|ETR-Quinols|ETR-Quinones|PROTON
RXN0-5260.p	DIHYDROXY-ACETONE-PHOSPHATE|ETR-Quinols|ETR-Quinones|GLYCEROL-3P
RXN0-5261.c	D-LACTATE|E-|PROTON|PYRUVATE
RXN0-5262.c	CPD-7670|DMSO|E-|PROTON|WATER
RXN0-5263.c	E-|PROTON|TRIMENTHLAMINE-N-O|TRIMETHYLAMINE|WATER
RXN0-5264.p	Menaquinols|Menaquinones|PROTON|TRIMENTHLAMINE-N-O|TRIMETHYLAMINE|WATER
RXN0-5265.c	E-|OXYGEN-MOLECULE|PROTON|WATER
RXN0-5266.cp	OXYGEN-MOLECULE|PROTON|Ubiquinols|Ubiquinones|WATER
RXN0-5267.cp	PROTON
RXN0-5268.cp	OXYGEN-MOLECULE|PROTON|Ubiquinols|Ubiquinones|WATER
RXN0-5269.c	E-|L-LACTATE|PROTON|PYRUVATE
RXN0-5285.c	CPD0-1090|D-GLUCARATE
RXN0-5289.c	GLYCERATE|NAD|NADH|PROTON|TARTRONATE-S-ALD
RXN0-5291.c	ADP|CPD0-1095|PROTON|Pi|THIAMINE-PYROPHOSPHATE
RXN0-5292.c	DCMP|DEOXYCYTIDINE|Pi|WATER
RXN0-5294.p	CPD0-1099|CPD0-1101|CPD0-939|WATER
RXN0-5295.c	CPD-1162|GLC-6-P|HYDROQUINONE|WATER
RXN0-5297.c	CPD-1181|CPD-173|GLC-6-P|WATER
RXN0-5298.c	CPD-10329|CPD0-1107
RXN0-5304.c	CPD0-1108|CPD0-1110
RXN0-5305.c	CPD0-1108
RXN0-5306.c	CPD0-1112|RHAMNOSE
RXN0-5307.c	CPLX0-7650|FUCULOSE-1P|PD00444
RXN0-5309.c	CPD-9956|E-|PROTON|UBIQUINONE-8
RXN0-5311.c	ADENOSYL-HOMO-CYS|N2-Methyladenine-containing-rRNAs|S-ADENOSYLMETHIONINE|rRNA-Holder
RXN0-5322.c	CPLX0-2861|CPLX0-7657|Pi
RXN0-5329.c	CPD0-1122|CPD0-1123
RXN0-5330.p	NAD|NADH|PROTON|Ubiquinols|Ubiquinones
RXN0-5332.c	CPLX0-7651|PD01352|URACIL
RXN0-5344.c	CPLX0-7669|CPLX0-7670|LYS
RXN0-5345.c	ARG|CPLX0-7669|CPLX0-7671
RXN0-5347.c	CPLX0-7677|EG11969-MONOMER|ZN+2
RXN0-5354.c	CPLX0-7679|CPLX0-7680|ZN+2
RXN0-5358.c	CPLX0-7681|EG11146-MONOMER|XANTHOSINE
RXN0-5359.p	C-DI-GMP|GTP|PPI
RXN0-5361.c	23-cyclic-nucloetide-PO4|3-phosphooligonucleotides|RNA-Holder|WATER
RXN0-5363.c	ALLOLACTOSE
RXN0-5364.c	2-KETOGLUTARATE|CPD-381|HYDROGEN-PEROXIDE|OXYGEN-MOLECULE
RXN0-5372.c	CPLX0-7689|EG11962-MONOMER|L-LACTATE
RXN0-5375.c	ANTHRANILATE|CPD0-1147|CPD0-1148|NAD|NADH|PROTON
RXN0-5377.c	CPD0-1099|GUANOSINE_DIPHOSPHATE_FUCOSE|UDP-GLUCOSE|UDP-GLUCURONATE
RXN0-5382.c	CPLX0-7701|G6420-MONOMER|MN+2
RXN0-5383.p	CPD-9646|CPD0-1151|CPD0-939|PROTON|UNDECAPRENYL-DIPHOSPHATE
RXN0-5384.c	CPLX0-7702|CU+|G6263-MONOMER
RXN0-5387.c	CPD0-1156|CPD0-1157|NADP|NADPH|PROTON
RXN0-5388.cp	Menaquinols|Menaquinones|NAD|NADH|PROTON
RXN0-5389.c	CPLX0-7713|CPLX0-7714|D-SERINE
RXN0-5390.c	CO-A|CPD0-1158|CPD0-1159|PROTON|WATER
RXN0-5391.c	CPD0-1158|CPD0-1162
RXN0-5392.c	2-ACETO-LACTATE|CPLX0-7715|PD00200
RXN0-5393.c	CPD0-1162|CPD0-1163|WATER
RXN0-5395.c	3-BETA-D-GLUCOSYLGLUCOSE|ALPHA-GLUCOSE|WATER
RXN0-5398.c	PSEUDOURIDINE-5-P|RIBOSE-5P|URACIL|WATER
RXN0-5401.c	CPD0-1171|CPD0-1182|D-ALANINE|EG10544-MONOMER
RXN0-5401.p	CPD0-1171|CPD0-1182|D-ALANINE|EG10544-MONOMER
RXN0-5402.e	CPD0-1182|CPD0-1183|CPD0-1185|D-ALANINE
RXN0-5402.p	CPD0-1182|CPD0-1183|CPD0-1185|D-ALANINE
RXN0-5405.p	C6|CPD-12231|PROTON|UNDECAPRENYL-DIPHOSPHATE
RXN0-5407.p	CPD0-1183|CPD0-1184|CPD0-1185|WATER
RXN0-5408.c	D-MYO-INOSITOL-1-MONOPHOSPHATE|MYO-INOSITOL|Pi|WATER
RXN0-5409.c	CPD0-1189|CPD0-888|FORMATE|WATER
RXN0-5410.c	GLYCEROL-3P|L-GLYCERALDEHYDE-3-PHOSPHATE|NADP|NADPH|PROTON
RXN0-5413.p	CPD0-1192|UDP|UDP-N-ACETYL-D-GLUCOSAMINE
RXN0-5414.p	ACET|CPD0-1192|CPD0-1193|PROTON|WATER
RXN0-5418.c	ACETYL-COA|ADP|ATP|CO-A|Elongation-tRNAmet|Elongator-tRNAMet-acetylcytidine|PROTON|Pi|WATER
RXN0-5419.c	ADENOSYL-HOMO-CYS|Methylated-Ribosomal-Protein-L11s|Nonmethylated-Ribosomal-Protein-L11s|S-ADENOSYLMETHIONINE
RXN0-5422.c	AMP|ATP|GLT|PPI|PROTON|tRNAs-Asp-with-queuosine|tRNAs-with-glutamylated-queuosine
RXN0-5423.c	CPLX0-7716|G6889-MONOMER|METHYL-GLYOXAL
RXN0-5433.c	DEHYDRO-3-DEOXY-L-RHAMNONATE|LACTALD|PYRUVATE
RXN0-5435.c	Pre-crRNAs|crRNAs
RXN0-5437.c	ADENOSYL-HOMO-CYS|N6N6-Dimethyladenine-Containing-rRNAs|S-ADENOSYLMETHIONINE|rRNA-Holder
RXN0-5450.c	CPD-207|CPLX0-7729|G6720-MONOMER
RXN0-5454.c	ASN|CPLX0-7733|CPLX0-7735
RXN0-5455.c	3-HYDROXY-PROPIONATE|HYDROXYPROPANAL|NAD|NADH|PROTON|WATER
RXN0-5456.c	CPD-763|CPLX0-7736|EG12235-MONOMER
RXN0-5459.c	ANTIMONITE|CPLX0-7739|EG12235-MONOMER
RXN0-5460.c	CPD-10551|CPD-67|CPD0-1317
RXN0-5461.c	ADP|ATP|CPD-10551|DIHYDROXYPENTANEDIONE|PROTON
RXN0-5462.c	GDP|GTP|PROTON|Pi|WATER
RXN0-5462.e	GDP|GTP|PROTON|Pi|WATER
RXN0-5462.p	GDP|GTP|PROTON|Pi|WATER
RXN0-5463.c	CPD-8179|CPLX0-7742|EG10603-MONOMER
RXN0-5464.c	CPD-7970|CPLX0-7743|EG10603-MONOMER
RXN0-5465.c	CPD0-881|CPLX0-7746|G7262-MONOMER
RXN0-5468.c	Alcohols|Alkyl-Hydro-Peroxides|Ox-Thioredoxin|Red-Thioredoxin|WATER
RXN0-5487.c	CPLX0-7751|EG11212-MONOMER|NITRIC-OXIDE
RXN0-5501.c	CPLX0-7752|CPLX0-7759|HOMO-CYS
RXN0-5507.c	ACETALD|CPD0-1699|DIHYDRONEOPTERIN-P3|P3I|PROTON|WATER
RXN0-5509.c	WATER|mRNAs|ssRNAs
RXN0-5510.c	PPI|WATER|mRNAs|mRNAs-with-5-monophosphate
RXN0-5513.p	ACP|AMP|ATP|Fatty-Acids|PPI|Saturated-Fatty-Acyl-ACPs
RXN0-5514.p	2-3-4-Saturated-L-Phosphatidates|ACP|Saturated-2-Lysophosphatidates|Saturated-Fatty-Acyl-ACPs
RXN0-5515.p	2-3-4-Saturated-L-Phosphatidates|CDP-2-3-4-Saturated-Diacylglycerols|CTP|PPI|PROTON
RXN0-5522.c	CPD0-1719|CPLX0-7800
RXN0-6.cp	FE+2|PROTON
RXN0-6254.c	CPD-8123|CPD0-1882|CTP|PPI|PROTON
RXN0-6256.c	2-MERCAPTOETHANOL|CPD0-1885|GLUTATHIONE|OXIDIZED-GLUTATHIONE
RXN0-6258.c	FE+2|PROTOHEME|PROTON|PROTOPORPHYRIN_IX
RXN0-6258.p	FE+2|PROTOHEME|PROTON|PROTOPORPHYRIN_IX
RXN0-6259.c	Menaquinols|Menaquinones|PROTOPORPHYRINOGEN|PROTOPORPHYRIN_IX
RXN0-6271.c	ADP|ATP|G6345-MONOMER|PHOSPHO-DPIB
RXN0-6272.c	G6345-MONOMER|G6346-MONOMER|PHOSPHO-DPIA|PHOSPHO-DPIB
RXN0-6274.c	CPD-4211|PPI
RXN0-6277.c	BIOTIN|CPD-722|Ox-Thioredoxin|Red-Thioredoxin|WATER
RXN0-6277.e	BIOTIN|CPD-722|Ox-Thioredoxin|Red-Thioredoxin|WATER
RXN0-6359.c	HCN|HSCN|PROTON|Sulfurated-Sulfur-Acceptors|Unsulfurated-Sulfur-Acceptors
RXN0-6361.c	CPLX0-7756|CPLX0-8047|NITRIC-OXIDE
RXN0-6362.c	CPLX0-8048|EG12694-MONOMER|TARTRATE
RXN0-6366.c	ADENOSYL-HOMO-CYS|CH33ADO|MET|PROTON|S-ADENOSYLMETHIONINE|Sulfurated-Sulfur-Acceptors|Unsulfurated-Sulfur-Acceptors
RXN0-6367.c	CPD-11770|CPD0-2101|NADP|NADPH|PROTON
RXN0-6368.c	CPD-11770|DIHYDROMONAPTERIN-TRIPHOSPHATE|PROTON|Pi|WATER
RXN0-6369.p	NITRATE|NITRITE|Ubiquinols|Ubiquinones|WATER
RXN0-6370.c	E-|NITRATE|NITRITE|PROTON|WATER
RXN0-6371.p	Acceptor|Aldonic-Acids|Aldoses|Donor-H2|PROTON|WATER
RXN0-6372.c	E-|GLC-D-LACTONE|PROTON
RXN0-6373.p	GLC-D-LACTONE|Ubiquinols|Ubiquinones
RXN0-6375.c	ACET|CARBON-DIOXIDE|E-|PROTON|PYRUVATE|WATER
RXN0-6381.c	WATER|mRNAs|ssRNAs
RXN0-6382.c	IMP|ITP|PPI|PROTON|WATER
RXN0-6385.c	HS|Ox-Thioredoxin|PROTON|Red-Thioredoxin|S2O3|SO3
RXN0-6388.c	ADP|ATP|G7345-MONOMER|MONOMER0-4141
RXN0-6389.c	EG11285-MONOMER|G7345-MONOMER|MONOMER0-4141|MONOMER0-4147
RXN0-6409.c	CPLX0-7740|CPLX0-8051|CYTIDINE
RXN0-6418.p	D-Glucose|GLC
RXN0-6427.c	GDP-TP|GTP|PPI|PROTON|WATER
RXN0-6434.c	CPLX0-8053|EG10942-MONOMER
RXN0-6435.c	AMP|ATP|CARBAMOYL-P|EG10487-MONOMER|MONOMER0-4166|PPI|Pi
RXN0-6436.c	CPD0-881|CPLX0-7745|CPLX0-8054
RXN0-6442.c	2-3-DIHYDROXYBENZOATE|AMP|ATP|CPLX0-7849|ENTB-CPLX|PPI
RXN0-6442.e	2-3-DIHYDROXYBENZOATE|AMP|ATP|CPLX0-7849|ENTB-CPLX|PPI
RXN0-6444.c	CPD0-2338|FMN|FMNH2|OXYGEN-MOLECULE|PROTON|URACIL
RXN0-6445.c	CHEY-MONOMER|MONOMER0-4170|NAD|NIACINAMIDE|WATER
RXN0-6446.c	ADP|ATP|EG12658-MONOMER|MONOMER0-4171
RXN0-6450.c	CPD0-2331|CPD0-2338|NAD|NADH|WATER
RXN0-6451.c	CARBAMATE|CPD0-2331|CPD0-2339|PROTON|WATER
RXN0-6452.c	AMMONIUM|CPD0-2339|MALONATE-S-ALD|PROTON|WATER
RXN0-6459.c	CPLX0-7721|DCUR-MONOMER|DCUS-MONOMER|PHOSPHO-DCUS-MONOMER
RXN0-6460.c	CARBAMATE|CPD0-2338|CPD0-2340|PROTON|WATER
RXN0-6461.c	Acceptor|CPD0-2339|CPD0-2340|Donor-H2|PROTON|WATER
RXN0-6462.ce	ADP|ATP|G6318-MONOMER|MONOMER0-4178
RXN0-6464.ce	G6318-MONOMER|G6319-MONOMER|MONOMER0-4178|MONOMER0-4180
RXN0-6465.c	CPD0-1938|CPLX0-8055|EG12116-MONOMER
RXN0-6466.c	CPLX0-7854|CPLX0-8056|TREHALOSE-6P
RXN0-6467.c	CPLX0-8057|GLYCEROL|PD03576
RXN0-6468.c	CPLX0-8058|PD01352|THYMINE
RXN0-6469.c	CPD0-2342|CPLX0-8059|PD01896
RXN0-6470.c	CPLX0-8060|GLY|PD00339
RXN0-6471.c	CPLX0-8061|EG11320-MONOMER|ZN+2
RXN0-6478.p	CPD0-2350|CPD0-2351|WATER
RXN0-6479.c	CPD0-2351|CPD0-2352|Nucleoside-Monophosphates|WATER
RXN0-6480.c	CPD0-2354|ssRNAs|tRNAs
RXN0-6481.c	CPD0-2352|CPD0-2354|Pi|Ribonucleoside-Diphosphates
RXN0-6482.c	CPD0-2353|Pi|Ribonucleoside-Diphosphates|tRNAs
RXN0-6483.c	CPD0-2352|CPD0-2354|Ribonucleoside-Monophosphates
RXN0-6484.c	CPD0-2353|Nucleoside-Monophosphates|tRNAs
RXN0-6485.p	CPD0-2350|CPD0-2352|WATER
RXN0-6487.c	CPD-347|HYDROXYPROPANAL|NADP|NADPH|PROTON
RXN0-6489.c	CARNITINE|CPLX0-7666|CPLX0-8062
RXN0-6490.c	DI-H-OROTATE|E-|OROTATE|PROTON
RXN0-6491.p	DI-H-OROTATE|OROTATE|Ubiquinols|Ubiquinones
RXN0-6493.c	ADP|ATP|EVGS-MONOMER|MONOMER0-4184
RXN0-6494.c	MONOMER0-4184|MONOMER0-4185
RXN0-6495.c	MONOMER0-4185|PHOSPHO-EVGS
RXN0-6499.c	CPLX0-7754|PHOSPHO-UHPB|UHPA-MONOMER|UHPB-MONOMER
RXN0-6501.c	CPLX0-7795|KDPD-MONOMER|KDPE-MONOMER|PHOSPHO-KDPD
RXN0-6502.c	ADP|ATOS-MONOMER|ATP|PHOSPHO-ATOS
RXN0-6503.ce	OMPR-MONOMER|PHOSPHO-ENVZ|PHOSPHO-OMPR
RXN0-6505.c	PC00084|PD02233|RCSB-MONOMER
RXN0-6506.c	EG12385-MONOMER|MONOMER0-4189|MONOMER0-4194|RCSC-MONOMER
RXN0-6507.c	MONOMER0-4194|PHOSPHO-RCSC
RXN0-6509.ce	CPLX0-7884|EG12385-MONOMER|MONOMER0-4189|RCSB-MONOMER
RXN0-6510.c	CPD0-2362|CPD0-2363
RXN0-6511.c	CPD0-2363|CPD0-2364|NADP|NADPH|PROTON|WATER
RXN0-6512.c	ACETYL-COA|CO-A|CPD0-2364|CPD0-2365
RXN0-6513.c	3-HYDROXYADIPYL-COA|CPD0-2365|WATER
RXN0-6515.c	16S-rRNA-N2-methylguanine966|16S-rRNA-guanine-966|ADENOSYL-HOMO-CYS|PROTON|S-ADENOSYLMETHIONINE
RXN0-6518.c	ADP|ATP|PHOSPHO-TORS|TORS-CPLX
RXN0-6519.c	PHOSPHO-TORR|PHOSPHO-TORS850|TORR-CPLX|TORS-CPLX
RXN0-6521.p	RNASE-E-MRNA-PROCESSING-SUBSTRATE|RNASE-E-PROCESSING-PRODUCT-MRNA|ssRNAs
RXN0-6522.p	5S-rRNAs|9S-RRNA|ssRNAs
RXN0-6523.c	RNASE-G-DEGRADATION-SUBSTRATE-MRNA|ssRNAs
RXN0-6524.c	AMP|RNASE-II-POLY-A-SUBSTRATE-MRNA|RNASE-II-SUBSTRATE-WITH-NO-POLY-A-TAIL
RXN0-6525.c	MUTATED-TRNA|Nucleoside-Monophosphates
RXN0-6526.c	23S-rRNAs|ssRNAs
RXN0-6526.p	23S-rRNAs|ssRNAs
RXN0-6527.c	rRNA-Holder|ssRNAs
RXN0-6527.p	rRNA-Holder|ssRNAs
RXN0-6528.c	YHAV-DEGRADATION-SUBSTRATE-MRNA|ssRNAs
RXN0-6529.c	YHAV-DEGRADATION-SUBSTRATE-RRNA|ssRNAs
RXN0-6531.c	AMP|ATP|CPD0-1032|EG12099-MONOMER|MONOMER0-4200|PPI
RXN0-6532.c	ADP|ATP|GLNL-CPLX|PROTEIN-NRIIP
RXN0-6533.c	GLNG-CPLX|GLNL-CPLX|PROTEIN-NRIIP|PROTEIN-NRIP
RXN0-6541.c	ADP|ATP|D-SEDOHEPTULOSE-1-7-P2|D-SEDOHEPTULOSE-7-P|PROTON
RXN0-6542.c	ADP|ATP|MONOMER0-4206|PROTEIN-CHEA
RXN0-6546.c	CHEY-MONOMER|MONOMER0-4206|PHOSPHO-CHEY|PROTEIN-CHEA
RXN0-6547.c	CHEB-MONOMER|MONOMER0-4206|PHOSPHO-CHEB|PROTEIN-CHEA
RXN0-6549.c	BR-|BROMOACETATE|CPD0-2370|GLUTATHIONE|PROTON
RXN0-6550.c	ADENINE|CH33ADO|CPD0-2167|WATER
RXN0-6554.p	DI-H-OROTATE|Menaquinols|Menaquinones|OROTATE
RXN0-6555.c	FE+2|NADP|NADPH|PROTON|Siderophore
RXN0-6556.c	5-Phosphopolynucleotides|5-Prime-Adenylylated-Polynucleotide|ATP|PPI
RXN0-6560.c	PHOSPHO-BARA-ASP
RXN0-6561.c	MONOMER0-4210|PHOSPHO-BARA-ASP
RXN0-6562.c	3-P-HYDROXYPYRUVATE|OH-PYR|Pi|WATER
RXN0-6563.c	CPD0-2189|GLY|GLYCOLALDEHYDE
RXN0-6564.c	4-PHOSPHONOOXY-THREONINE|ADP|ATP|CPD0-2189|PROTON
RXN0-6565.c	DIHYDRO-THYMINE|NAD|NADH|PROTON|THYMINE
RXN0-6566.c	5Prime-OH-Terminated-RNAs|Cyclic-Phosphate-Terminated-RNAs|GMP|GTP|Ligated-RNAs|PPI
RXN0-6571.c	CPLX0-8069|G7594-MONOMER|NI+2
RXN0-6575.c	AMMONIUM|CPD-13043|CPD0-1699|PROTON
RXN0-6576.c	ADENOSYL-HOMO-CYS|CPD-4544|CPD0-2381|S-ADENOSYLMETHIONINE
RXN0-6675.p	Diacylglycerol-Prolipoproteins|EG10544-MONOMER|Lysophospholipids|Phospholipids
RXN0-6676.c	CPD-13314|CPD-6602|NADP|NADPH|PROTON
RXN0-6677.c	CPD-13314|CPD-13315|NADP|NADPH|PROTON
RXN0-6678.c	2-Oxo-carboxylates|AMMONIUM|D-Amino-Acids|E-|PROTON|WATER
RXN0-6684.c	AMMONIUM|D-ALANINE|E-|PROTON|PYRUVATE|WATER
RXN0-6705.p	1-PALMITOYLGLYCEROL-3-PHOSPHATE|ACP|CPD0-1422|Palmitoyl-ACPs
RXN0-6707.c	CPLX0-8070|EG10230-MONOMER|GUANOSINE-5DP-3DP
RXN0-6708.c	AMMONIUM|CPD0-2461|PROTON|WATER|XANTHINE
RXN0-6710.c	CPD0-2463|PROTON|RIBOSE-15-BISPHOSPHATE|WATER
RXN0-6717.c	PHOSPHO-ENOL-PYRUVATE|PTSI-MONOMER|PTSI-PHOSPHORYLATED|PYRUVATE
RXN0-6718.c	PTSH-MONOMER|PTSH-PHOSPHORYLATED|PTSI-MONOMER|PTSI-PHOSPHORYLATED
RXN0-6720.c	CPD0-2467|CPD0-2468|WATER
RXN0-6721.c	HYDROGEN-PEROXIDE|L-Methionine-sulfoxides|MET|WATER
RXN0-6722.c	NAD|NADH|Quinones|Semiquinones
RXN0-6723.c	ALLANTOIN|CPLX0-8071|G6276-MONOMER
RXN0-6725.p	2-LYSOPHOSPHATIDYLETHANOLAMINES|Fatty-Acids|L-1-PHOSPHATIDYL-ETHANOLAMINE|PROTON|WATER
RXN0-6726.c	ADP|ATP|CPD0-2471|GLT|PROTON|Pi|alpha-N-Peptidyl-LGlutamate
RXN0-6727.c	ADP|AMP|CPD-653|NADH|PROTON|Pi
RXN0-6731.c	16S-rRNA-N2methylguanine1516|16S-rRNA-guanine1516|ADENOSYL-HOMO-CYS|PROTON|S-ADENOSYLMETHIONINE
RXN0-6732.c	ADENINE|ATP|CPD0-1068|CPD0-2479
RXN0-6733.p	CPD0-2479|CPD0-2480|PPI|PROTON|WATER
RXN0-6734.c	CH4|CPD0-2463|CPD0-2480
RXN0-6938.c	CPD0-2482|FERRIC-ENTEROBACTIN-COMPLEX|WATER
RXN0-6941.c	CPD0-2482|CPD0-2483|FE+2|NADP|NADPH|PROTON
RXN0-6944.c	CPD0-2483|N-23-DIHYDROXYBENZOYL-L-SERINE|PROTON|WATER
RXN0-6945.c	3-MERCAPTO-PYRUVATE|HS|PROTON|PYRUVATE
RXN0-6948.c	ACETYL-COA|CO-A|CPD0-2015|MET|PROTON
RXN0-6949.c	CPLX0-8074|CU+|G6569-MONOMER
RXN0-6950.c	23S-rRNA-N7-methylguanine-2069|23S-rRNA-guanine-2069|ADENOSYL-HOMO-CYS|S-ADENOSYLMETHIONINE
RXN0-6952.p	2-ACYL-GPE|Fatty-Acids|L-1-PHOSPHATIDYL-ETHANOLAMINE|PROTON|WATER
RXN0-6954.c	AMMONIUM|E-|NITRITE|PROTON|WATER
RXN0-6957.c	PPI|PROTON|WATER
RXN0-6973.c	BUTANAL|CPD-3744|FMN|FMNH2|OXYGEN-MOLECULE|PROTON|SO3|WATER
RXN0-6974.c	CPD-13393|GLY|MET|WATER
RXN0-6975.c	CPD-13404|L-ALPHA-ALANINE|L-ASPARTATE|WATER
RXN0-6976.c	CPD-13403|GLN|L-ALPHA-ALANINE|WATER
RXN0-6977.c	ALA-GLY|GLY|L-ALPHA-ALANINE|WATER
RXN0-6978.c	CPD-13401|HIS|L-ALPHA-ALANINE|WATER
RXN0-6979.c	CPD-13398|L-ALPHA-ALANINE|LEU|WATER
RXN0-6980.c	CPD-13397|L-ALPHA-ALANINE|THR|WATER
RXN0-6981.c	CPD0-1445|GLT|L-ALPHA-ALANINE|WATER
RXN0-6982.c	ASN|CPD-13395|GLY|WATER
RXN0-6983.c	CPD-13394|GLN|GLY|WATER
RXN0-6984.c	CPD-3569|GLT|GLY|WATER
RXN0-6985.c	CPD-13390|L-ALPHA-ALANINE|MET|WATER
RXN0-6987.c	CPD-13406|GLY|L-ASPARTATE|WATER
RXN0-6988.c	CPD-10814|GLY|PRO|WATER
RXN0-6989.c	ARG
RXN0-6990.p	CYS|CYSTINE
RXN0-6991.c	LYS
RXN0-6992.p	CPD0-1564|D-CYSTEINE
RXN0-6994.c	GLC-6-P|METOH|WATER
RXN0-6995.c	CPLX0-7884|Pi
RXN0-6998.c	ADENOSYL-HOMO-CYS|PROTON|S-ADENOSYLMETHIONINE
RXN0-6999.c	AMP|ATP|CPD0-1032|PPI|PROTON
RXN0-7.c	CPD-3|CPLX0-2541|CPLX0-6
RXN0-7000.c	NADP|NADPH|OXYGEN-MOLECULE|PROTON|WATER
RXN0-7001.c	ACET|DIACETYLCHITOBIOSE-6-PHOSPHATE|WATER
RXN0-7002.c	GLUCOSAMINE|N-ACETYL-D-GLUCOSAMINE-6-P|WATER
RXN0-7005.c	E-|L-DELTA1-PYRROLINE_5-CARBOXYLATE|PRO|PROTON
RXN0-7007.c	ADENOSYL-HOMO-CYS|CH33ADO|MET|S-ADENOSYLMETHIONINE
RXN0-7008.p	L-DELTA1-PYRROLINE_5-CARBOXYLATE|PRO|PROTON|Ubiquinols|Ubiquinones
RXN0-7009.c	DIACETYLCHITOBIOSE-6-PHOSPHATE
RXN0-7010.c	GLUTATHIONE|OXIDIZED-GLUTATHIONE
RXN0-7012.c	CARDIOLIPIN|ETHANOL-AMINE|L-1-PHOSPHATIDYL-ETHANOLAMINE|L-1-PHOSPHATIDYL-GLYCEROL
RXN0-7013.c	ACET|ADENOSINE_DIPHOSPHATE_RIBOSE|WATER
RXN0-7014.c	ACETYL-COA|CO-A|CPD0-1074
RXN0-7020.c	25-DIDEHYDRO-D-GLUCONATE|CPD-13059|NADP|NADPH|PROTON
RXN0-7021.c	CPD-13059|L-IDONATE|NADP|NADPH|PROTON
RXN0-7022.c	ADP|ATP|CPD0-1082|PROTON|Pi|UDP-MURNAC-TETRAPEPTIDE|UDP-N-ACETYLMURAMATE
RXN0-7022.e	ADP|ATP|CPD0-1082|PROTON|Pi|UDP-MURNAC-TETRAPEPTIDE|UDP-N-ACETYLMURAMATE
RXN0-7023.c	Nucleoside-Monophosphates|WATER
RXN0-7024.c	CPD-1091|CPD-389|NAD|NADH|PROTON
RXN0-703.c	3-KETO-L-GULONATE|CPD-334|NAD|NADH|PROTON
RXN0-7039.ce	ADP|ATP
RXN0-704.c	3-KETO-L-GULONATE|ADP|ATP|CPD-2343|PROTON
RXN0-7041.ce	PROTON|Pi|THIAMINE-PYROPHOSPHATE|WATER
RXN0-7041.cp	PROTON|Pi|THIAMINE-PYROPHOSPHATE|WATER
RXN0-7046.c	CO-A|PROTON|WATER
RXN0-7047.c	PHOSPHO-ENOL-PYRUVATE|PYRUVATE
RXN0-705.c	CARBON-DIOXIDE|CPD-2343|L-XYLULOSE-5-P|PROTON
RXN0-7050.cp	MET|PROTON
RXN0-7066.c	PHENYL-PYRUVATE|PREPHENATE|S-ADENOSYLMETHIONINE|WATER
RXN0-7067.c	ADENOSYL-HOMO-CYS|PROTON
RXN0-7068.c	DIHYDROFOLATE|GDP|GLY|GTP|METHYLENE-THF|Pi|WATER|tRNA-uridine34
RXN0-7069.c	5-METHYLTHIOADENOSINE|PD04032
RXN0-7071.c	ADENINE|PD04032
RXN0-7074.c	Aminated-Amine-Donors|Deaminated-Amine-Donors|PYRIDOXAL_PHOSPHATE|PYRIDOXAMINE-5P
RXN0-7075.c	ACET|ACETYL-COA|OXALATE|OXALYL-COA
RXN0-7077.cp	PROTON
RXN0-7078.c	NAD|NIACINAMIDE|WATER
RXN0-7079.c	PPI|PROTON|WATER
RXN0-7080.c	5-HYDROXY-CTP|CPD-12377|CTP|PROTON
RXN0-7081.c	GLYOX|tRNA-containing-5-CarbMeAminome-2-ThioU
RXN0-7082.c	DIHYDROFOLATE|GDP|GLY|GTP|METHYLENE-THF|Pi|WATER|tRNA-2-thiouridine34|tRNA-containing-5-CarbMeAminome-2-ThioU
RXN0-7083.c	AMMONIUM|DIHYDROFOLATE|GDP|GTP|METHYLENE-THF|Pi|WATER|tRNA-2-thiouridine34
RXN0-7084.c	ARCB-MONOMER|EG12121-MONOMER|PHOSPHO-ARCB717|RSSB-P
RXN0-722.c	DUDP|Oxidized-NrdH-Proteins|Reduced-NrdH-Proteins|UDP|WATER
RXN0-723.c	CTP|DCTP|Oxidized-flavodoxins|Reduced-flavodoxins|WATER
RXN0-724.c	DUTP|Oxidized-flavodoxins|Reduced-flavodoxins|UTP|WATER
RXN0-742.c	5-PHOSPHORIBOSYL-5-AMINOIMIDAZOLE|ADP|ATP|CPD0-181|HCO3|PROTON|Pi
RXN0-743.c	CPD0-181|PHOSPHORIBOSYL-CARBOXY-AMINOIMIDAZOLE
RXN0-745.c	ATP|DATP|Oxidized-flavodoxins|Reduced-flavodoxins|WATER
RXN0-746.c	DGTP|GTP|Oxidized-flavodoxins|Reduced-flavodoxins|WATER
RXN0-747.c	ADP|DADP|Oxidized-NrdH-Proteins|Reduced-NrdH-Proteins|WATER
RXN0-748.c	DGDP|GDP|Oxidized-NrdH-Proteins|Reduced-NrdH-Proteins|WATER
RXN0-8.ce	ENTEROBACTIN
RXN0-801.c	PPI|PROTEIN-PII2|URIDYLYL-PII2|UTP
RXN0-802.c	PROTEIN-PII2|UMP|URIDYLYL-PII2
RXN0-882.c	2C-METH-D-ERYTHRITOL-CYCLODIPHOSPHATE|HYDROXY-METHYL-BUTENYL-DIP|Oxidized-ferredoxins|PROTON|Reduced-ferredoxins|WATER
RXN0-884.c	CPD-4211|HYDROXY-METHYL-BUTENYL-DIP|NAD-P-OR-NOP|NADH-P-OR-NOP|PROTON|WATER
RXN0-901.c	NAD|NADH|PROTON|URATE|WATER|XANTHINE
RXN0-921.c	G7546-MONOMER|GLYCOLLATE|MONOMER0-562
RXN0-947.c	ACP|Lipoyl-Protein|Octanoyl-ACPs|Octanoylated-domains|PROTON
RXN0-949.c	CH33ADO|Lipoyl-Protein-N6-lipoyllysine|MET|Octanoylated-domains|PROTON|S-ADENOSYLMETHIONINE|Sulfurated-Sulfur-Acceptors|Unsulfurated-Sulfur-Acceptors
RXN0-961.c	CPD0-2190|L-ALA-GAMMA-D-GLU-DAP|MESO-DIAMINOPIMELATE|WATER
RXN0-962.c	ADP|ATP|FRUCTOSELYSINE|FRUCTOSELYSINE-6-PHOSPHATE|PROTON
RXN0-963.c	FRUCTOSELYSINE-6-PHOSPHATE|GLC-6-P|LYS|WATER
RXN0-984.c	2-KETOGLUTARATE|ADENINE|CARBON-DIOXIDE|FORMALDEHYDE|N1-METHYLADENINE|OXYGEN-MOLECULE|SUC
RXN0-985.c	2-KETOGLUTARATE|CARBON-DIOXIDE|CYTOSINE|FORMALDEHYDE|N3-METHYLCYTOSINE|OXYGEN-MOLECULE|PROTON|SUC
RXN0-986.c	1-ETHYLADENINE|2-KETOGLUTARATE|ACETALD|ADENINE|CARBON-DIOXIDE|OXYGEN-MOLECULE|SUC
RXN66-521.c	ADP|ATP|PROTON
RXN66-526.p	Pi|WATER
RXNMETA-12671.c	CPD0-2363|CPDMETA-13650|WATER
RXNMETA-12672.c	CPD0-2364|CPDMETA-13650|NADP|NADPH|PROTON|WATER
S-ADENMETSYN-RXN.c	ATP|MET|PPI|Pi|S-ADENOSYLMETHIONINE|WATER
S-FORMYLGLUTATHIONE-HYDROLASE-RXN.c	CPD-548|FORMATE|GLUTATHIONE|PROTON|WATER
SAICARSYN-RXN.c	ADP|ATP|L-ASPARTATE|P-RIBOSYL-4-SUCCCARB-AMINOIMIDAZOLE|PHOSPHORIBOSYL-CARBOXY-AMINOIMIDAZOLE|PROTON|Pi
SAMDECARB-RXN.c	CARBON-DIOXIDE|PROTON|S-ADENOSYLMETHIONINAMINE|S-ADENOSYLMETHIONINE
SEDOBISALDOL-RXN.c	D-SEDOHEPTULOSE-1-7-P2|DIHYDROXY-ACETONE-PHOSPHATE|ERYTHROSE-4P
SELENOCYSTEINE-LYASE-RXN.c	Acceptor|Donor-H2|L-ALPHA-ALANINE|L-SELENOCYSTEINE|PROTON|SE-2
SERINE--TRNA-LIGASE-RXN.c	AMP|ATP|Charged-SER-tRNAs|PPI|PROTON|SER|SER-tRNAs
SERINE-O-ACETTRAN-RXN.c	ACETYL-COA|ACETYLSERINE|CO-A|SER
SHIKIMATE-5-DEHYDROGENASE-RXN.c	3-DEHYDRO-SHIKIMATE|NADP|NADPH|PROTON|SHIKIMATE
SHIKIMATE-KINASE-RXN.c	ADP|ATP|PROTON|SHIKIMATE|SHIKIMATE-5P
SIROHEME-FERROCHELAT-RXN.c	FE+2|PROTON|SIROHEME|SIROHYDROCHLORIN
SORB6PDEHYDROG-RXN.c	D-SORBITOL-6-P|NAD|NADH|PROTON
SPERMACTRAN-RXN.c	ACETYL-COA|CO-A|CPD-568|PROTON|SPERMIDINE
SPERMIDINESYN-RXN.c	5-METHYLTHIOADENOSINE|PROTON|PUTRESCINE|S-ADENOSYLMETHIONINAMINE|SPERMIDINE
SPONTPRO-RXN.c	L-DELTA1-PYRROLINE_5-CARBOXYLATE|L-GLUTAMATE_GAMMA-SEMIALDEHYDE|PROTON|WATER
SUCCARGDIHYDRO-RXN.c	AMMONIUM|CARBON-DIOXIDE|CPD-421|N2-SUCCINYLORNITHINE|PROTON|WATER
SUCCCOASYN-RXN.c	ADP|ATP|CO-A|Pi|SUC|SUC-COA
SUCCDIAMINOPIMDESUCC-RXN.c	LL-DIAMINOPIMELATE|N-SUCCINYLLL-2-6-DIAMINOPIMELATE|SUC|WATER
SUCCGLUALDDEHYD-RXN.c	CPD-822|N2-SUCCINYLGLUTAMATE|NAD|NADH|PROTON|WATER
SUCCGLUDESUCC-RXN.c	GLT|N2-SUCCINYLGLUTAMATE|SUC|WATER
SUCCINATE-SEMIALDEHYDE-DEHYDROGENASE-RXN.c	NAD|NADH|PROTON|SUC|SUCC-S-ALD|WATER
SUCCINYLDIAMINOPIMTRANS-RXN.c	2-KETOGLUTARATE|GLT|N-SUCCINYL-2-AMINO-6-KETOPIMELATE|N-SUCCINYLLL-2-6-DIAMINOPIMELATE
SUCCORNTRANSAM-RXN.c	2-KETOGLUTARATE|CPD-822|GLT|N2-SUCCINYLORNITHINE
SUCCSEMIALDDEHYDROG-RXN.c	NADP|NADPH|PROTON|SUC|SUCC-S-ALD|WATER
SUGAR-PHOSPHATASE-RXN.c	Pi|Sugar|Sugar-Phosphate|WATER
SULFATE-ADENYLYLTRANS-RXN.c	APS|ATP|PPI|PROTON|SULFATE
SULFITE-REDUCT-RXN.c	HS|NADP|NADPH|PROTON|SO3|WATER
SUPEROX-DISMUT-RXN.c	HYDROGEN-PEROXIDE|OXYGEN-MOLECULE|PROTON|SUPER-OXIDE
SUPEROX-DISMUT-RXN.p	HYDROGEN-PEROXIDE|OXYGEN-MOLECULE|PROTON|SUPER-OXIDE
TAGAALDOL-RXN.c	DIHYDROXY-ACETONE-PHOSPHATE|GAP|TAGATOSE-1-6-DIPHOSPHATE
TAGAKIN-RXN.c	ADP|ATP|PROTON|TAGATOSE-1-6-DIPHOSPHATE|TAGATOSE-6-PHOSPHATE
TDCEACT1-RXN.c	CH33ADO|KETOBUTFORMLY-INACT-MONOMER|KETOBUTFORMLY-MONOMER|Oxidized-flavodoxins|Reduced-flavodoxins|S-ADENOSYLMETHIONINE
TDPFUCACTRANS-RXN.p	ACETYL-COA|CO-A|PROTON|TDP-D-FUCOSAMINE|TDP-FUC4NAC
TETHYDPICSUCC-RXN.c	CO-A|DELTA1-PIPERIDEINE-2-6-DICARBOXYLATE|N-SUCCINYL-2-AMINO-6-KETOPIMELATE|SUC-COA|WATER
TETRAACYLDISACC4KIN-RXN.p	ADP|ATP|BISOHMYR-GLC|LIPID-IV-A|PROTON
THI-P-KIN-RXN.c	ADP|ATP|THIAMINE-P|THIAMINE-PYROPHOSPHATE
THI-P-SYN-RXN.c	AMINO-HYDROXYMETHYL-METHYLPYRIMIDINE-PP|PPI|PROTON|THIAMINE-P|THZ-P
THIAZOLSYN2-RXN.c	CPD-12279|CPD-13575|DEOXYXYLULOSE-5P|Thi-S|Thiocarboxyadenylated-ThiS-Proteins|WATER
THIAZOLSYN3-RXN.c	ADP|ATP|PROTON|THZ|THZ-P
THIFAMP-RXN.c	ATP|PPI|THIS-COAMP-MONOMER|THIS-MONOMER
THIFIS-RXN.c	AMP|CYS|L-ALPHA-ALANINE|THIS-COAMP-MONOMER|THIS-COSH-MONOMER
THIKIN-RXN.c	ADP|ATP|PROTON|THIAMINE|THIAMINE-P
THIOESTER-RXN.p	CO-A|CPD66-39|PROTON|Saturated-Fatty-Acyl-CoA|WATER
THIOREDOXIN-REDUCT-NADPH-RXN.c	NADP|NADPH|Ox-Thioredoxin|PROTON|Red-Thioredoxin
THIOREDOXIN-RXN.c	E-|Ox-Thioredoxin|Red-Thioredoxin
THIOSULFATE-SULFURTRANSFERASE-RXN.c	HCN|HSCN|PROTON|S2O3|SO3
THIOSULFATE-SULFURTRANSFERASE-RXN.p	HCN|HSCN|PROTON|S2O3|SO3
THREDEHYD-RXN.c	2-OXOBUTANOATE|AMMONIUM|THR
THREODEHYD-RXN.c	AMINO-OXOBUT|NAD|NADH|PROTON|THR
THREONINE--TRNA-LIGASE-RXN.c	AMP|ATP|Charged-THR-tRNAs|PPI|PROTON|THR|THR-tRNAs
THREONINE-ALDOLASE-RXN.c	ACETALD|GLY|THR
THREOSPON-RXN.c	AMINO-ACETONE|AMINO-OXOBUT|CARBON-DIOXIDE|PROTON
THRESYN-RXN.c	O-PHOSPHO-L-HOMOSERINE|Pi|THR|WATER
THTOREDUCT-RXN.p	Acceptor|Donor-H2|TETRAHYDROTHIOPHENE|TETRAHYDROTHIOPHENE-1-OXIDE|WATER
THYKI-RXN.c	ADP|ATP|PROTON|THYMIDINE|TMP
THYM-PHOSPH-RXN.c	DEOXY-D-RIBOSE-1-PHOSPHATE|Pi|THYMIDINE|THYMINE
THYMIDYLATE-5-PHOSPHATASE-RXN.c	Pi|THYMIDINE|TMP|WATER
THYMIDYLATESYN-RXN.c	DIHYDROFOLATE|DUMP|METHYLENE-THF|TMP
TMAOREDUCT-RXN.c	NAD|NADH|PROTON|TRIMENTHLAMINE-N-O|TRIMETHYLAMINE|WATER
TORS850-RXN.c	PHOSPHO-TORASP|PHOSPHO-TORS850
TORSASP-RXN.c	PHOSPHO-TORASP|PHOSPHO-TORS
TORT-RXN.c	BOUND-TORT|TORT-MONOMER|TRIMENTHLAMINE-N-O
TRANS-RXN-1.cp	FORMATE
TRANS-RXN-10.cp	L-ARABINOSE|PROTON
TRANS-RXN-100.cp	CARNITINE|GAMMA-BUTYROBETAINE
TRANS-RXN-101.cp	NA+|PROTON
TRANS-RXN-104.cp	L-LACTATE|PROTON
TRANS-RXN-105.cp	GLYCOLLATE|PROTON
TRANS-RXN-106.cp	FUM|SUC
TRANS-RXN-106A.cp	L-ASPARTATE|SUC
TRANS-RXN-106B.cp	MAL|SUC
TRANS-RXN-106D.cp	C4-dicarboxylates|PROTON
TRANS-RXN-108.cp	Nucleosides|PROTON
TRANS-RXN-108A.cp	ADENOSINE|PROTON
TRANS-RXN-108B.cp	CYTIDINE|PROTON
TRANS-RXN-108C.cp	DEOXYADENOSINE|PROTON
TRANS-RXN-108D.cp	DEOXYCYTIDINE|PROTON
TRANS-RXN-108E.cp	DEOXYINOSINE|PROTON
TRANS-RXN-108F.cp	DEOXYURIDINE|PROTON
TRANS-RXN-108G.cp	INOSINE|PROTON
TRANS-RXN-108H.cp	PROTON|THYMIDINE
TRANS-RXN-108I.cp	PROTON|URIDINE
TRANS-RXN-112.cp	L-rhamnose|PROTON
TRANS-RXN-113.cp	2-DEHYDRO-3-DEOXY-D-GLUCONATE|PROTON
TRANS-RXN-114.cp	PROTON|Pi
TRANS-RXN-116.cp	CYTOSINE|PROTON
TRANS-RXN-117.cp	NA+|PANTOTHENATE
TRANS-RXN-118.cp	NA+|PRO
TRANS-RXN-121.cp	PROTON|SUC
TRANS-RXN-121A.cp	MAL|PROTON
TRANS-RXN-121B.cp	FUM|PROTON
TRANS-RXN-121C.cp	OROTATE|PROTON
TRANS-RXN-122.cp	GLT|NA+
TRANS-RXN-122A.cp	L-ASPARTATE|PROTON
TRANS-RXN-123.cp	D-GALACTURONATE|PROTON
TRANS-RXN-125.cp	L-ALPHA-ALANINE|NA+
TRANS-RXN-126.cp	ILE|NA+
TRANS-RXN-126A.cp	NA+|VAL
TRANS-RXN-126B.cp	LEU|NA+
TRANS-RXN-127.cp	SUC|TARTRATE
TRANS-RXN-129.cp	NA+|PROTON
TRANS-RXN-130.cp	NA+|PROTON
TRANS-RXN-131.cp	GLYCEROL
TRANS-RXN-132.cp	PROTON|URACIL
TRANS-RXN-137.cp	NITRITE
TRANS-RXN-139.cp	CL-
TRANS-RXN-14.cp	CPD-69
TRANS-RXN-141.cp	MG+2
TRANS-RXN-141A.cp	CO+2
TRANS-RXN-141B.cp	NI+2
TRANS-RXN-142.cp	INDOLE|PROTON
TRANS-RXN-143.cp	K+
TRANS-RXN-144.cp	CA+2
TRANS-RXN-145.cp	WATER
TRANS-RXN-146.cp	O-Antigens
TRANS-RXN-153.cp	CPD-1162|HYDROQUINONE-O-BETA-D-GLUCOPYRANOSIDE|PTSH-MONOMER|PTSH-PHOSPHORYLATED
TRANS-RXN-153A.cp	CPD-1142|CPD-1181|PTSH-MONOMER|PTSH-PHOSPHORYLATED
TRANS-RXN-155.cp	CELLOBIOSE|CPD-507|PTSH-MONOMER|PTSH-PHOSPHORYLATED
TRANS-RXN-155B.cp	CHITOBIOSE|DIACETYLCHITOBIOSE-6-PHOSPHATE|PTSH-MONOMER|PTSH-PHOSPHORYLATED
TRANS-RXN-156.cp	MANNITOL|MANNITOL-1P|PTSH-MONOMER|PTSH-PHOSPHORYLATED
TRANS-RXN-157.cp	GLC|GLC-6-P|PTSH-MONOMER|PTSH-PHOSPHORYLATED
TRANS-RXN-158.cp	BETA-D-FRUCTOSE|FRU1P|PTSH-MONOMER|PTSH-PHOSPHORYLATED
TRANS-RXN-158A.cp	BETA-D-FRUCTOSE|FRUCTOSE-6P|PTSH-MONOMER|PTSH-PHOSPHORYLATED
TRANS-RXN-16.cp	D-GALACTONATE|PROTON
TRANS-RXN-161.cp	GALACTITOL|GALACTITOL-1-PHOSPHATE|PTSH-MONOMER|PTSH-PHOSPHORYLATED
TRANS-RXN-162.cp	GLT|PROTON
TRANS-RXN-165.cp	MANNOSE-6P|PTSH-MONOMER|PTSH-PHOSPHORYLATED
TRANS-RXN-167.cp	N-ACETYL-D-GLUCOSAMINE|N-ACETYL-D-GLUCOSAMINE-6-P|PTSH-MONOMER|PTSH-PHOSPHORYLATED
TRANS-RXN-167A.cp	D-GLUCOSAMINE-6-P|GLUCOSAMINE|PTSH-MONOMER|PTSH-PHOSPHORYLATED
TRANS-RXN-168.cp	PTSH-MONOMER|PTSH-PHOSPHORYLATED|TREHALOSE|TREHALOSE-6P
TRANS-RXN-169.cp	D-SORBITOL-6-P|PTSH-MONOMER|PTSH-PHOSPHORYLATED|SORBITOL
TRANS-RXN-181A.cp	L-IDONATE|PROTON
TRANS-RXN-2.cp	ADP|ATP|K+|PROTON|Pi|WATER
TRANS-RXN-20.cp	PROTON
TRANS-RXN-205A.cp	Peptide-Antibiotics
TRANS-RXN-21.cp	GALACTOSE|PROTON
TRANS-RXN-22.cp	GLYCEROL-3P|Pi
TRANS-RXN-23.cp	2-KETOGLUTARATE|PROTON
TRANS-RXN-236.cp	ADP|ATP|CPD0-939|PROTON|Pi|WATER
TRANS-RXN-237.ce	Lipopolysaccharides
TRANS-RXN-238.cp	ADP|ATP|PROTON|Pi|WATER
TRANS-RXN-24.cp	PROTON
TRANS-RXN-241.cp	MN+2|PROTON
TRANS-RXN-242.cp	HOMO-SER|PROTON
TRANS-RXN-242A.cp	HOMOSERINE-LACTONE|PROTON
TRANS-RXN-249.ce	ADP|ATP|PROTON|Pi|WATER
TRANS-RXN-249.cp	ADP|ATP|PROTON|Pi|WATER
TRANS-RXN-25.cp	N-ACETYLNEURAMINATE|PROTON
TRANS-RXN-250.cp	ADP|ATP|MG+2|PROTON|Pi|WATER
TRANS-RXN-26.cp	NITRITE|PROTON
TRANS-RXN-261.cp	4-AMINO-BUTYRATE|GLT
TRANS-RXN-262.cp	ASN|PROTON
TRANS-RXN-27.cp	PROTON|SHIKIMATE
TRANS-RXN-29.cp	PRO|PROTON
TRANS-RXN-29A.cp	BETAINE|PROTON
TRANS-RXN-3.cp	K+|PROTON
TRANS-RXN-30.cp	D-Xylose|PROTON
TRANS-RXN-31.cp	PROTON|XANTHOSINE
TRANS-RXN-33.cp	GLC-6-P|Pi
TRANS-RXN-35.cp	GLUCURONATE|PROTON
TRANS-RXN-40.cp	L-ARABINOSE|PROTON
TRANS-RXN-41.cp	CPD0-441|PROTON
TRANS-RXN-42.cp	K+|PROTON
TRANS-RXN-44.cp	Drugs|PROTON
TRANS-RXN-56.cp	PHE|PROTON
TRANS-RXN-57.cp	4-AMINO-BUTYRATE|PROTON
TRANS-RXN-58.cp	LYS|PROTON
TRANS-RXN-61.cp	3-HYDROXYPHENYL-PROPIONATE|PROTON
TRANS-RXN-62A.cp	D-ALANINE|PROTON
TRANS-RXN-62B.cp	GLY|PROTON
TRANS-RXN-68.cp	CADAVERINE|LYS
TRANS-RXN-69.cp	PROTON|PUTRESCINE
TRANS-RXN-7.cp	ADP|ARSENATE|ATP|PROTON|Pi|WATER
TRANS-RXN-71.cp	PROTON|SER
TRANS-RXN-72.cp	PROTON|THR
TRANS-RXN-76.cp	PROTON|TRP
TRANS-RXN-77.cp	PROTON|TYR
TRANS-RXN-8.cp	FE+2
TRANS-RXN-81.cp	FRUCTURONATE|PROTON
TRANS-RXN-82.cp	PROTON
TRANS-RXN-86.cp	Unspecified-Ion-Or-Solute
TRANS-RXN-90.ce	AG+|PROTON
TRANS-RXN-92.ce	Drugs|PROTON
TRANS-RXN-94.cp	MELIBIOSE|PROTON
TRANS-RXN-94A.cp	MELIBIOSE|NA+
TRANS-RXN-94B.cp	LI+|MELIBIOSE
TRANS-RXN-98.cp	Glucuronides|PROTON
TRANS-RXN-99.cp	CHOLINE|PROTON
TRANS-RXN0-0244.cp	PROTON|THR
TRANS-RXN0-162.cp	ADP|ATP|PROTOHEME|PROTON|Pi|WATER
TRANS-RXN0-181.cp	POLYPEPTIDE
TRANS-RXN0-200.cp	PROTON|ZN+2
TRANS-RXN0-201.cp	CIT|SUC
TRANS-RXN0-202.cp	ADP|ATP|CPD-218|PROTON|Pi|WATER
TRANS-RXN0-203.cp	D-GALACTARATE
TRANS-RXN0-204.cp	D-GLUCARATE
TRANS-RXN0-205.cp	PYRIDOXINE
TRANS-RXN0-206.cp	AMMONIUM
TRANS-RXN0-207.cp	ADP|ATP|CU+|PROTON|Pi|WATER
TRANS-RXN0-209.cp	GLUCONATE|PROTON
TRANS-RXN0-211.cp	L-ORNITHINE|PUTRESCINE
TRANS-RXN0-212.cp	CADAVERINE|PROTON
TRANS-RXN0-213.cp	PYRIDOXAMINE
TRANS-RXN0-214.cp	PYRIDOXAL
TRANS-RXN0-222.cp	ADP|ATP|L-ASPARTATE|PROTON|Pi|WATER
TRANS-RXN0-224.ce	ADP|ATP|Macrolide-Antibiotics|Pi|WATER
TRANS-RXN0-226.cp	CPD0-1080|PROTON
TRANS-RXN0-227.cp	CPD0-1083|PROTON
TRANS-RXN0-228.cp	5-DEHYDROGLUCONATE|PROTON
TRANS-RXN0-233.cp	4-hydroxybenzoate|PROTON
TRANS-RXN0-234.c	E-|Menaquinols|Menaquinones|PROTON
TRANS-RXN0-235.cp	CPD-334|NA+
TRANS-RXN0-236.cp	L-LYXOSE|PROTON
TRANS-RXN0-237.c	E-|PROTON|Ubiquinols|Ubiquinones
TRANS-RXN0-238.cp	PROTON
TRANS-RXN0-239.cp	NITRATE|NITRITE
TRANS-RXN0-240.cp	BIOTIN
TRANS-RXN0-244.cp	CD+2|PROTON
TRANS-RXN0-258.cp	CPD0-1081|PROTON
TRANS-RXN0-264.cp	CPD-763|PROTON
TRANS-RXN0-265.cp	Aromatic-Amino-Acids
TRANS-RXN0-266.cp	PROTON|SPERMIDINE
TRANS-RXN0-267.cp	PROTON|TRIPEPTIDES
TRANS-RXN0-268.cp	ADP|ATP|L-ALA-GAMMA-D-GLU-DAP|PROTON|Pi|WATER
TRANS-RXN0-269.cp	VAL
TRANS-RXN0-270.cp	LEU|PROTON
TRANS-RXN0-272.cp	CPD-195
TRANS-RXN0-273.cp	DMSO
TRANS-RXN0-274.cp	4-HYDROXY-BENZYL-ALCOHOL
TRANS-RXN0-275.ce	CPD0-1193
TRANS-RXN0-275.cp	CPD0-1193
TRANS-RXN0-276.cp	CPD0-1189
TRANS-RXN0-277.cp	NAD|NADH|NADP|NADPH|PROTON
TRANS-RXN0-278.cp	LIPOIC-ACID
TRANS-RXN0-279.cp	C55-PP-GLCNAC-MANNACA-FUC4NAC
TRANS-RXN0-280.ce	CU+|PROTON
TRANS-RXN0-281.cp	3-KETOBUTYRATE
TRANS-RXN0-282.cp	3-PHENYLPROPIONATE
TRANS-RXN0-283.ce	COBINAMIDE
TRANS-RXN0-283.cp	COBINAMIDE
TRANS-RXN0-284.cp	PHENYLACETALDEHYDE
TRANS-RXN0-286.cp	C6
TRANS-RXN0-288.cp	DIPEPTIDES|PROTON
TRANS-RXN0-417.cp	FRUCTOSELYSINE
TRANS-RXN0-418.cp	PSICOSELYSINE
TRANS-RXN0-443.cp	Long-Chain-Fatty-Acids
TRANS-RXN0-444.cp	S-ALLANTOIN
TRANS-RXN0-445.ce	CHITOBIOSE
TRANS-RXN0-445.cp	CHITOBIOSE
TRANS-RXN0-446.cp	N-ACETYL-D-MANNOSAMINE|N-ACETYL-D-MANNOSAMINE-6P|PTSH-MONOMER|PTSH-PHOSPHORYLATED
TRANS-RXN0-447.cp	ADENINE|PROTON
TRANS-RXN0-448.cp	CPD-1093
TRANS-RXN0-449.ce	N-23-DIHYDROXYBENZOYL-L-SERINE
TRANS-RXN0-451.cp	CPD-660|PROTON
TRANS-RXN0-452.cp	CPD0-889|PROTON
TRANS-RXN0-453.cp	CPD-10774
TRANS-RXN0-454.cp	ADP|ATP|CPD-10774|PROTON|Pi|WATER
TRANS-RXN0-455.ce	COBINAMIDE
TRANS-RXN0-457.cp	CPD-10797|PROTON
TRANS-RXN0-459.cp	METOH
TRANS-RXN0-460.cp	UREA
TRANS-RXN0-461.cp	CPD-560
TRANS-RXN0-462.cp	HMP
TRANS-RXN0-463.cp	DIMETHYLBENZIMIDAZOLE
TRANS-RXN0-464.cp	THZ
TRANS-RXN0-465.ce	3-HYDROXY-PROPIONATE
TRANS-RXN0-466.cp	CPD-674
TRANS-RXN0-467.cp	CPD-8891
TRANS-RXN0-468.ce	Nucleosides
TRANS-RXN0-468.cp	Nucleosides
TRANS-RXN0-469.cp	L-ALPHA-ALANINE
TRANS-RXN0-470.cp	Pi
TRANS-RXN0-473.ce	ACETYLMALTOSE
TRANS-RXN0-474.cp	OXYGEN-MOLECULE
TRANS-RXN0-475.cp	CPD-722
TRANS-RXN0-476.cp	ETHANOL-AMINE
TRANS-RXN0-478.cp	ADP|ATP|PROTON|Pi|SELENATE|WATER
TRANS-RXN0-479.cp	ADP|ATP|PROTON|Pi|SELENITE|WATER
TRANS-RXN0-480.cp	L-SELENOCYSTEINE
TRANS-RXN0-481.cp	NICOTINAMIDE_RIBOSE
TRANS-RXN0-486.cp	CPD-397
TRANS-RXN0-487.cp	MN+2
TRANS-RXN0-488.ce	CPD0-621
TRANS-RXN0-490.ce	BETAINE
TRANS-RXN0-491.cp	ADP|ATP|CPD0-2486|PROTON|Pi|WATER
TRANS-RXN0-492.cp	ADP|ATP|CPD0-2485|PROTON|Pi|WATER
TRANS-RXN0-493.cp	Drugs|PROTON
TRANS-RXN0-495.cp	D-SERINE
TRANS-RXN0-496.cp	ENTEROBACTIN
TRANS-RXN0-497.cp	CA+2
TRANS-RXN0-498.cp	F-
TRANS-RXN0-499.cp	D-TARTRATE|SUC
TRANS-RXN0-500.cp	CPD-108
TRANS-RXN0-501.cp	FRUCTOSE-6P|Pi
TRANS-RXN0-502.cp	MANNOSE-6P|Pi
TRANS-RXN0-503.cp	ADP|ATP|MALTOTRIOSE|PROTON|Pi|WATER
TRANS-RXN0-504.cp	ADP|ATP|MALTOTETRAOSE|PROTON|Pi|WATER
TRANS-RXN0-505.cp	PROPIONATE
TRANS-RXN0-506.cp	PYRUVATE
TRANS-RXN0-507.cp	CYSTINE
TRANS-RXN0-508.cp	CPD-3740
TRANS-RXN0-509.cp	HYPOTAURINE
TRANS-RXN0-510.cp	ADP|ATP|CPD-3738|PROTON|Pi|WATER
TRANS-RXN0-511.cp	ADP|ATP|L-Methionine-sulfoxides|PROTON|Pi|WATER
TRANS-RXN0-512.cp	L-CYSTATHIONINE
TRANS-RXN0-513.cp	CPD-3736
TRANS-RXN0-514.cp	CPD0-1564
TRANS-RXN0-515.cp	D-LACTATE|PROTON
TRANS-RXN0-517.cp	C4-dicarboxylates|PROTON
TRANS-RXN0-518.cp	CPD-3570|PTSH-MONOMER|PTSH-PHOSPHORYLATED
TRANS-RXN0-519.cp	CPD-3565|PROTON
TRANS-RXN0-520.cp	METHYL-BETA-D-GALACTOSIDE|NA+
TRANS-RXN0-522.cp	D-GALACTONO-1-4-LACTONE
TRANS-RXN0-523.cp	GLYCERATE
TRANS-RXN0-524.cp	THYMINE
TRANS-RXN0-525.cp	CPD0-1159
TRANS-RXN0-526.cp	CH4
TRANS-RXN0-527.cp	CHOLATE
TRANS-RXN0-528.cp	CPD-173
TRANS-RXN0-529.cp	HYDROQUINONE
TRANS-RXN0-530.cp	PROTON|URATE
TRANS-RXN0-531.ce	Lipopolysaccharides
TRANS-RXN0-531.cp	Lipopolysaccharides
TRANS-RXN0-532.cp	BETAINE|PROTON
TRANS-RXN0-533.cp	CHOLINE|PROTON
TRANS-RXN0-534.cp	L-GLYCERALDEHYDE-3-PHOSPHATE|Pi
TRANS-RXN0-535.cp	L-GLYCERALDEHYDE-3-PHOSPHATE
TRANS-RXN0-537.cp	GLY
TRANS-RXN0-538.cp	CPD-497
TRANS-RXN0-539.cp	CPD0-1938
TRANS-RXN0-540.cp	2-DEOXY-D-GLUCOSE|2-DEOXY-D-GLUCOSE-6-PHOSPHATE|PTSH-MONOMER|PTSH-PHOSPHORYLATED
TRANS-RXN0-541.cp	ADP|ATP|METHYL-BETA-D-GALACTOSIDE|PROTON|Pi|WATER
TRANS-RXN0-543.cp	NITRATE|PROTON
TRANS-RXN0-544.cp	AMMONIA
TRANS-RXN0-545.cp	CARBON-DIOXIDE
TRANS-RXN0-546.cp	ETOH
TRANS-RXN0-547.cp	WATER
TRANS-RXN0-549.cp	CPD0-1192
TRANS-RXN0-550.cp	ARSENATE|PROTON
TRANS-RXN0-551.cp	CPD-763
TRANS-RXN0-552.cp	SUC
TRANS-RXN0-553.cp	FUM
TRANS-RXN0-554.cp	L-ASPARTATE
TRANS-RXN0-556.cp	CARBON-MONOXIDE
TRANS-RXN0-557.cp	ALLANTOIN
TRANS-RXN0-558.cp	2-OXOBUTANOATE
TRANS-RXN0-559.cp	DIHYDROXYACETONE
TRANS-RXN0-560.cp	URACIL
TRANS-RXN0-561.cp	XANTHINE
TRANS-RXN0-562.cp	HYPOXANTHINE
TRANS-RXN0-563.cp	INDOLE
TRANS-RXN0-564.cp	CAMP
TRANS-RXN0-565.cp	GMP
TRANS-RXN0-566.cp	IMP
TRANS-RXN0-567.cp	ACET
TRANS-RXN0-570.cp	PYRUVATE
TRANS-RXN0-571.cp	ACET|PROTON
TRANS-RXN0-572.ce	HYDROGEN-PEROXIDE
TRANS-RXN0-573.cp	ADP|ATP|Glycerophosphodiesters|PROTON|Pi|WATER
TRANS-RXN0-574.cp	GLC
TRANS-RXN0-575.cp	MALTOSE
TRANS-RXN0-576.cp	CPD-4544
TRANS-RXN0-577.cp	ADENINE
TRANS-RXN0-578.cp	GUANINE
TRANS-RXN0-579.cp	HYPOXANTHINE
TRANSALDOL-RXN.c	D-SEDOHEPTULOSE-7-P|ERYTHROSE-4P|FRUCTOSE-6P|GAP
TRANSENOYLCOARED-RXN.c	NADP|NADPH|PROTON|Saturated-Fatty-Acyl-CoA|TRANS-D2-ENOYL-COA
TRE6PHYDRO-RXN.c	GLC-6-P|TREHALOSE-6P|WATER
TREHALA-RXN.c	ALPHA-GLUCOSE|GLC|TREHALOSE|WATER
TREHALA-RXN.p	ALPHA-GLUCOSE|GLC|TREHALOSE|WATER
TREHALOSE6PSYN-RXN.c	ALPHA-GLC-6-P|PROTON|TREHALOSE-6P|UDP
TREHALOSEPHOSPHA-RXN.c	Pi|TREHALOSE|TREHALOSE-6P|WATER
TRIOSEPISOMERIZATION-RXN.c	DIHYDROXY-ACETONE-PHOSPHATE|GAP
TRIPHOSPHATASE-RXN.c	P3I|PPI|Pi|WATER
TRNA-CYTIDYLYLTRANSFERASE-RXN.c	ATP|CTP|PPI|tRNA-precursors|tRNAs-with-CCA
TRNA-GUANINE-N7--METHYLTRANSFERASE-RXN.c	ADENOSYL-HOMO-CYS|Guanine46-in-tRNA|S-ADENOSYLMETHIONINE|tRNA-Containing-N7-Methylguanine-46
TRNA-NUCLEOTIDYLTRANSFERASE-RXN.c	Nucleoside-Diphosphates|Pi|RNA-Holder
TRNA-PSEUDOURIDINE-SYNTHASE-I-RXN.c	tRNA-pseudouridine-38-40|tRNA-uridine-38-40
TRNA-S-TRANSFERASE-RXN.c	Activated-tRNA|CYS|SER|tRNA-Containing-Thionucleotide
TRNA-URACIL-5--METHYLTRANSFERASE-RXN.c	ADENOSYL-HOMO-CYS|PROTON|S-ADENOSYLMETHIONINE|tRNA-containing-5Me-uridine54
TRYPSYN-RXN.c	GAP|INDOLE-3-GLYCEROL-P|SER|TRP|WATER
TRYPTOPHAN--TRNA-LIGASE-RXN.c	AMP|ATP|Charged-TRP-tRNAs|PPI|PROTON|TRP|TRP-tRNAs
TRYPTOPHAN-RXN.c	AMMONIUM|INDOLE|PYRUVATE|TRP|WATER
TSA-REDUCT-RXN.c	GLYCERATE|NAD-P-OR-NOP|NADH-P-OR-NOP|PROTON|TARTRONATE-S-ALD
TYROSINE--TRNA-LIGASE-RXN.c	AMP|ATP|Charged-TYR-tRNAs|PPI|PROTON|TYR|TYR-tRNAs
TYROSINE-AMINOTRANSFERASE-RXN.c	2-KETOGLUTARATE|GLT|P-HYDROXY-PHENYLPYRUVATE|TYR
UBIQUINOL-OX-RXN.c	Cytochromes-B|Cytochromes-B-Reduced|Ox-Ubiquinone-8-Oxidoreductases|Red-Ubiquinol-8-Oxidoreductases
UDP-NACMUR-ALA-LIG-RXN.c	ADP|ATP|CPD0-1456|L-ALPHA-ALANINE|PROTON|Pi|UDP-N-ACETYLMURAMATE
UDP-NACMURALA-GLU-LIG-RXN.c	ADP|ATP|CPD0-1456|D-GLT|PROTON|Pi|UDP-AA-GLUTAMATE
UDP-NACMURALGLDAPAALIG-RXN.c	ADP|ATP|C1|D-ALA-D-ALA|PROTON|Pi|UDP-AAGM-DIAMINOHEPTANEDIOATE
UDP-NACMURALGLDAPLIG-RXN.c	ADP|ATP|MESO-DIAMINOPIMELATE|PROTON|Pi|UDP-AA-GLUTAMATE|UDP-AAGM-DIAMINOHEPTANEDIOATE
UDPACYLGLCNACDEACETYL-RXN.c	ACET|UDP-OHMYR-ACETYLGLUCOSAMINE|UDP-OHMYR-GLUCOSAMINE|WATER
UDPGLCNACEPIM-RXN.c	UDP-MANNAC|UDP-N-ACETYL-D-GLUCOSAMINE
UDPHYDROXYMYRGLUCOSAMNACETYLTRANS-RXN.c	ACP|OH-MYRISTOYL|PROTON|R-3-hydroxymyristoyl-ACPs|UDP-OHMYR-GLUCOSAMINE
UDPKIN-RXN.c	ADP|ATP|UDP|UTP
UDPMANACATRANS-RXN.c	ACETYL-D-GLUCOSAMINYLDIPHOSPHO-UNDECAPRE|C55-PP-GLCNAC-MANNACA|PROTON|UDP|UDP-MANNACA
UDPMANNACADEHYDROG-RXN.c	NAD|NADH|PROTON|UDP-MANNAC|UDP-MANNACA|WATER
UDPNACETYLGLUCOSAMACYLTRANS-RXN.c	ACP|R-3-hydroxymyristoyl-ACPs|UDP-N-ACETYL-D-GLUCOSAMINE|UDP-OHMYR-ACETYLGLUCOSAMINE
UDPNACETYLGLUCOSAMENOLPYRTRANS-RXN.c	PHOSPHO-ENOL-PYRUVATE|Pi|UDP-ACETYL-CARBOXYVINYL-GLUCOSAMINE|UDP-N-ACETYL-D-GLUCOSAMINE
UDPNACETYLMURAMATEDEHYDROG-RXN.c	NADP|NADPH|PROTON|UDP-ACETYL-CARBOXYVINYL-GLUCOSAMINE|UDP-N-ACETYLMURAMATE
UDPREDUCT-RXN.c	DUDP|Ox-Thioredoxin|Red-Thioredoxin|UDP|WATER
UDPSUGARHYDRO-RXN.p	Alpha-D-aldose-1-phosphates|PROTON|UDP-sugar|UMP|WATER
UGD-RXN.c	NAD|NADH|PROTON|UDP-GLUCURONATE|WATER
UHPB-RXN.c	ADP|ATP|PHOSPHO-UHPB|UHPB-MONOMER
UHPC-RXN.c	GLC-6-P|GLU-UHPC|UHPC-MONOMER
UNDECAPRENYL-DIPHOSPHATASE-RXN.p	CPD-9646|PROTON|Pi|UNDECAPRENYL-DIPHOSPHATE|WATER
URA-PHOSPH-RXN.c	DEOXY-D-RIBOSE-1-PHOSPHATE|DEOXYURIDINE|Pi|URACIL
URACIL-PRIBOSYLTRANS-RXN.c	PPI|PRPP|UMP|URACIL
UREIDOGLYCOLATE-LYASE-RXN.c	CPD-1091|GLYOX|UREA
URIDINE-NUCLEOSIDASE-RXN.c	URACIL|URIDINE|WATER
URIDINEKIN-RXN.c	ADP|ATP|PROTON|UMP|URIDINE
URIDYLREM-RXN.c	PROTEIN-PII|UMP|URIDYLYL-PII
URITRANS-RXN.c	Gln-B|PPI|URIDYLYL-PROTEIN-PII|UTP
URKI-RXN.c	GDP|GTP|PROTON|UMP|URIDINE
UROGENDECARBOX-RXN.c	CARBON-DIOXIDE|COPROPORPHYRINOGEN_III|PROTON|UROPORPHYRINOGEN-III
UROGENIIISYN-RXN.c	HYDROXYMETHYLBILANE|UROPORPHYRINOGEN-III|WATER
UROPORIIIMETHYLTRANSA-RXN.c	ADENOSYL-HOMO-CYS|CPD-9038|PROTON|S-ADENOSYLMETHIONINE|UROPORPHYRINOGEN-III
URPHOS-RXN.c	Pi|RIBOSE-1P|URACIL|URIDINE
URUR-RXN.c	AMMONIUM|CPD-1091|CPD0-2298|WATER
VALINE--TRNA-LIGASE-RXN.c	AMP|ATP|Charged-VAL-tRNAs|PPI|PROTON|VAL|VAL-tRNAs
VALINE-PYRUVATE-AMINOTRANSFER-RXN.c	2-KETO-ISOVALERATE|L-ALPHA-ALANINE|PYRUVATE|VAL
XANPRIBOSYLTRAN-RXN.c	PPI|PRPP|XANTHINE|XANTHOSINE-5-PHOSPHATE
XANTHOSINEPHOSPHORY-RXN.c	Pi|RIBOSE-1P|XANTHINE|XANTHOSINE
XYLISOM-RXN.c	D-XYLULOSE
XYLONATE-DEHYDRATASE-RXN.c	WATER
XYLULOKIN-RXN.c	ADP|ATP|D-XYLULOSE|PROTON|XYLULOSE-5-PHOSPHATE
YIAE1-RXN.c	25-DIDEHYDRO-D-GLUCONATE|5-DEHYDROGLUCONATE|NADP|NADPH|PROTON
YIAE2-RXN.c	CPD-377|L-IDONATE|NADP|NADPH|PROTON
